,PLAYER_ID,PLAYER_NAME,TEAM_ID,TEAM_ABBREVIATION,GP,W,L,MIN,OREB,OREB_CONTEST,OREB_UNCONTEST,OREB_CONTEST_PCT,OREB_CHANCES,OREB_CHANCE_PCT,OREB_CHANCE_DEFER,OREB_CHANCE_PCT_ADJ,AVG_OREB_DIST,DREB,DREB_CONTEST,DREB_UNCONTEST,DREB_CONTEST_PCT,DREB_CHANCES,DREB_CHANCE_PCT,DREB_CHANCE_DEFER,DREB_CHANCE_PCT_ADJ,AVG_DREB_DIST,REB,REB_CONTEST,REB_UNCONTEST,REB_CONTEST_PCT,REB_CHANCES,REB_CHANCE_PCT,REB_CHANCE_DEFER,REB_CHANCE_PCT_ADJ,AVG_REB_DIST
0,1627773,AJ Hammons,1610612742,DAL,22,4,18,163.0,8,3,5,0.375,30,0.267,1,0.276,7.5,28,12,16,0.429,56,0.5,4,0.538,3.9,36,15,21,0.417,86,0.419,5,0.444,4.7
1,201166,Aaron Brooks,1610612754,IND,64,36,28,870.0,18,5,13,0.278,67,0.269,3,0.281,13.2,51,6,47,0.118,113,0.451,5,0.472,9.9,69,11,60,0.159,180,0.383,8,0.401,10.8
2,203932,Aaron Gordon,1610612753,ORL,80,29,51,2298.0,116,65,51,0.56,273,0.425,6,0.434,7.4,289,71,215,0.246,478,0.605,33,0.649,6.6,405,136,266,0.336,750,0.54,39,0.57,6.8
3,1626151,Aaron Harrison,1610612766,CHA,5,2,3,17.0,0,0,0,0.0,1,0.0,0,0.0,0.0,3,0,3,0.0,3,1.0,0,1.0,5.5,3,0,3,0.0,4,0.75,0,0.75,5.5
4,203940,Adreian Payne,1610612750,MIN,18,5,13,135.0,9,6,2,0.667,23,0.391,1,0.409,10.3,24,7,16,0.292,34,0.706,3,0.774,4.7,33,13,18,0.394,57,0.579,4,0.623,6.1
5,201143,Al Horford,1610612738,BOS,68,46,22,2193.0,95,52,43,0.547,251,0.378,8,0.391,9.4,370,126,242,0.341,676,0.547,48,0.589,6.3,465,178,285,0.383,927,0.502,56,0.534,7.0
6,2744,Al Jefferson,1610612754,IND,65,33,32,922.0,74,52,23,0.703,158,0.468,3,0.477,6.2,202,75,126,0.371,309,0.654,24,0.709,4.2,276,127,149,0.46,467,0.591,27,0.627,4.7
7,202329,Al-Farouq Aminu,1610612757,POR,61,33,28,1773.0,77,42,31,0.545,196,0.393,4,0.401,7.2,374,121,249,0.324,637,0.587,57,0.645,5.5,451,163,280,0.361,829,0.544,61,0.587,5.8
8,101187,Alan Anderson,1610612746,LAC,30,20,10,308.0,3,3,0,1.0,21,0.143,3,0.167,8.9,21,2,19,0.095,43,0.488,3,0.525,6.8,24,5,19,0.208,64,0.375,6,0.414,7.0
9,1626210,Alan Williams,1610612756,PHX,47,11,36,708.0,94,63,25,0.67,215,0.437,4,0.445,6.1,198,76,119,0.384,306,0.647,19,0.69,4.2,292,139,144,0.476,521,0.56,23,0.586,4.8
10,202692,Alec Burks,1610612762,UTA,42,26,16,653.0,17,9,8,0.529,56,0.304,2,0.315,9.2,103,26,77,0.252,168,0.613,13,0.665,6.2,120,35,85,0.292,224,0.536,15,0.574,6.6
11,203518,Alex Abrines,1610612760,OKC,68,37,31,1055.0,18,8,10,0.444,54,0.333,3,0.353,10.6,68,17,50,0.25,155,0.439,15,0.486,8.1,86,25,60,0.291,209,0.411,18,0.45,8.6
12,203458,Alex Len,1610612756,PHX,75,20,55,1528.0,155,101,45,0.652,363,0.427,10,0.439,5.6,348,122,223,0.351,587,0.593,50,0.648,4.4,503,223,268,0.443,949,0.53,60,0.566,4.7
13,1627816,Alex Poythress,1610612755,PHI,6,0,6,157.0,11,7,3,0.636,25,0.44,0,0.44,4.8,18,8,9,0.444,42,0.429,4,0.474,7.2,29,15,12,0.517,67,0.433,4,0.46,6.3
14,201582,Alexis Ajinca,1610612740,NOP,39,15,24,584.0,46,33,13,0.717,123,0.374,3,0.383,5.2,131,42,87,0.321,225,0.582,10,0.609,4.7,177,75,100,0.424,347,0.51,13,0.53,4.8
15,203459,Allen Crabbe,1610612757,POR,79,39,40,2254.0,19,6,13,0.316,103,0.184,4,0.192,19.3,207,53,153,0.256,400,0.518,29,0.558,7.3,226,59,166,0.261,503,0.449,33,0.481,8.3
16,202087,Alonzo Gee,1610612743,DEN,13,4,9,89.0,4,2,2,0.5,10,0.4,1,0.444,4.4,11,6,6,0.545,21,0.524,4,0.647,6.1,15,8,8,0.533,31,0.484,5,0.577,5.7
17,101161,Amir Johnson,1610612738,BOS,80,51,29,1608.0,118,85,27,0.72,326,0.362,8,0.371,5.3,248,106,142,0.427,515,0.482,52,0.536,4.5,366,191,169,0.522,841,0.435,60,0.469,4.8
18,2760,Anderson Varejao,1610612744,GSW,14,12,2,92.0,12,8,3,0.667,18,0.667,1,0.706,6.8,15,5,10,0.333,25,0.6,6,0.789,5.1,27,13,13,0.481,43,0.628,7,0.75,5.8
19,203083,Andre Drummond,1610612765,DET,81,36,45,2409.0,345,269,71,0.78,646,0.534,12,0.544,5.1,770,280,488,0.364,1071,0.719,68,0.768,3.6,1115,549,559,0.492,1714,0.651,80,0.682,4.0
20,2738,Andre Iguodala,1610612744,GSW,76,64,12,1998.0,51,22,28,0.431,106,0.481,7,0.515,10.2,253,63,187,0.249,456,0.555,33,0.598,9.3,304,85,215,0.28,562,0.541,40,0.582,9.4
21,203460,Andre Roberson,1610612760,OKC,79,46,33,2376.0,98,60,35,0.612,313,0.313,7,0.32,7.2,305,76,226,0.249,566,0.539,42,0.582,6.0,403,136,261,0.337,877,0.46,49,0.487,6.3
22,101106,Andrew Bogut,1610612739,CLE,27,8,19,583.0,56,38,17,0.679,113,0.496,3,0.509,6.2,162,59,102,0.364,262,0.618,27,0.689,4.0,218,97,119,0.445,372,0.586,30,0.637,4.6
23,1626150,Andrew Harrison,1610612763,MEM,72,38,34,1474.0,23,6,17,0.261,104,0.221,1,0.223,17.9,113,16,96,0.142,235,0.481,21,0.528,9.6,136,22,113,0.162,339,0.401,22,0.429,11.0
24,203094,Andrew Nicholson,1610612751,BKN,38,20,18,342.0,15,11,4,0.733,37,0.405,0,0.405,4.6,46,16,30,0.348,101,0.455,7,0.489,4.8,61,27,34,0.443,136,0.449,7,0.473,4.7
25,203952,Andrew Wiggins,1610612750,MIN,82,31,51,3048.0,102,70,28,0.686,348,0.293,8,0.3,6.8,226,78,147,0.345,440,0.514,35,0.558,7.4,328,148,175,0.451,788,0.416,43,0.44,7.3
26,203461,Anthony Bennett,1610612751,BKN,22,3,19,243.0,21,15,3,0.714,41,0.512,0,0.512,6.1,47,14,33,0.298,79,0.595,4,0.627,4.4,68,29,36,0.426,120,0.567,4,0.586,4.9
27,1626148,Anthony Brown,1610612753,ORL,11,3,8,159.0,8,2,5,0.25,13,0.615,1,0.667,14.3,25,3,22,0.12,34,0.735,3,0.806,8.3,33,5,27,0.152,47,0.702,4,0.767,9.6
28,203076,Anthony Davis,1610612740,NOP,75,31,44,2708.0,172,125,46,0.727,362,0.475,10,0.489,6.2,712,271,437,0.381,1053,0.676,61,0.718,4.8,884,396,483,0.448,1410,0.627,71,0.66,5.0
29,201627,Anthony Morrow,1610612741,CHI,49,25,24,714.0,12,6,5,0.5,42,0.286,0,0.286,12.9,19,3,17,0.158,57,0.333,6,0.373,13.6,31,9,22,0.29,99,0.313,6,0.333,13.1
30,201229,Anthony Tolliver,1610612758,SAC,65,26,39,1477.0,51,21,29,0.412,136,0.375,4,0.386,8.2,186,54,131,0.29,336,0.554,31,0.61,6.3,237,75,160,0.316,468,0.506,35,0.547,6.7
31,203462,Archie Goodwin,1610612751,BKN,15,8,7,214.0,7,4,2,0.571,29,0.241,0,0.241,7.2,21,3,18,0.143,41,0.512,3,0.553,6.6,28,7,20,0.25,70,0.4,3,0.418,6.7
32,202620,Arinze Onuaku,1610612753,ORL,8,3,5,28.0,2,2,0,1.0,4,0.5,0,0.5,2.3,4,3,1,0.75,10,0.4,0,0.4,2.2,6,5,1,0.833,14,0.429,0,0.429,2.2
33,203382,Aron Baynes,1610612765,DET,75,34,41,1163.0,111,83,26,0.748,304,0.365,5,0.371,5.1,222,83,134,0.374,406,0.547,55,0.632,4.4,333,166,160,0.498,708,0.47,60,0.514,4.7
34,201167,Arron Afflalo,1610612758,SAC,61,23,38,1580.0,9,3,6,0.333,82,0.11,3,0.114,11.8,116,9,107,0.078,224,0.518,14,0.552,8.7,125,12,113,0.096,306,0.408,17,0.433,9.1
35,203085,Austin Rivers,1610612746,LAC,74,43,31,2054.0,20,10,10,0.5,138,0.145,6,0.152,9.9,141,22,119,0.156,345,0.409,38,0.459,9.0,161,32,129,0.199,483,0.333,44,0.367,9.1
36,202340,Avery Bradley,1610612738,BOS,55,34,21,1835.0,65,30,32,0.462,220,0.295,2,0.298,8.8,269,48,221,0.178,484,0.556,46,0.614,5.9,334,78,253,0.234,704,0.474,48,0.509,6.4
37,1626253,Axel Toupane,1610612740,NOP,4,2,2,47.0,0,0,0,0.0,0,0.0,0,0.0,0.0,1,0,1,0.0,6,0.167,0,0.167,14.6,1,0,1,0.0,6,0.167,0,0.167,14.6
38,1627791,Ben Bentil,1610612742,DAL,3,2,1,10.0,0,0,0,0.0,0,0.0,0,0.0,0.0,2,1,1,0.5,3,0.667,0,0.667,6.9,2,1,1,0.5,3,0.667,0,0.667,6.9
39,203463,Ben McLemore,1610612758,SAC,61,27,34,1176.0,19,9,11,0.474,108,0.176,4,0.183,8.6,110,18,89,0.164,219,0.502,28,0.576,6.5,129,27,100,0.209,326,0.396,32,0.439,6.9
40,2757,Beno Udrih,1610612765,DET,39,18,21,560.0,6,1,5,0.167,38,0.158,0,0.158,21.5,51,7,44,0.137,91,0.56,8,0.614,8.9,57,8,49,0.14,129,0.442,8,0.471,10.2
41,202687,Bismack Biyombo,1610612753,ORL,81,29,52,1793.0,157,104,48,0.662,363,0.433,6,0.44,6.2,410,131,279,0.32,689,0.595,58,0.65,4.4,567,235,327,0.414,1050,0.54,64,0.575,4.9
42,201933,Blake Griffin,1610612746,LAC,61,40,21,2076.0,112,66,40,0.589,283,0.396,7,0.406,7.0,385,120,267,0.312,595,0.647,38,0.691,5.3,497,186,307,0.374,872,0.57,45,0.601,5.7
43,1626246,Boban Marjanovic,1610612765,DET,35,16,19,293.0,46,38,7,0.826,89,0.517,4,0.541,4.1,84,26,58,0.31,112,0.75,6,0.792,4.7,130,64,65,0.492,200,0.65,10,0.684,4.4
44,201628,Bobby Brown,1610612745,HOU,25,18,7,123.0,0,0,1,0.0,4,0.0,1,0.0,24.5,6,1,5,0.167,17,0.353,2,0.4,10.2,6,1,6,0.167,21,0.286,3,0.333,12.3
45,1626171,Bobby Portis,1610612741,CHI,64,30,34,1000.0,75,44,31,0.587,164,0.457,3,0.466,6.8,221,69,148,0.312,349,0.633,27,0.686,5.2,296,113,179,0.382,513,0.577,30,0.613,5.6
46,202711,Bojan Bogdanovic,1610612764,WAS,80,23,57,2064.0,37,21,15,0.568,181,0.204,7,0.213,10.0,240,43,198,0.179,435,0.552,34,0.599,6.6,277,64,213,0.231,616,0.45,41,0.482,7.0
47,2564,Boris Diaw,1610612762,UTA,73,45,28,1283.0,46,32,16,0.696,115,0.4,5,0.418,6.9,112,27,84,0.241,267,0.419,29,0.471,5.9,158,59,100,0.373,382,0.414,34,0.454,6.3
48,203078,Bradley Beal,1610612764,WAS,77,48,29,2684.0,53,19,35,0.358,210,0.252,12,0.268,14.7,187,39,148,0.209,397,0.471,27,0.505,9.3,240,58,183,0.242,606,0.396,39,0.423,10.6
49,201148,Brandan Wright,1610612763,MEM,28,14,14,447.0,31,16,13,0.516,74,0.419,4,0.443,6.1,47,21,27,0.447,89,0.528,3,0.547,5.1,78,37,40,0.474,163,0.479,7,0.5,5.5
50,101138,Brandon Bass,1610612746,LAC,52,29,23,577.0,43,31,12,0.721,104,0.413,0,0.413,6.0,86,28,58,0.326,141,0.61,6,0.637,5.2,129,59,70,0.457,245,0.527,6,0.54,5.5
51,1627742,Brandon Ingram,1610612747,LAL,79,26,53,2279.0,60,26,34,0.433,204,0.294,10,0.309,9.1,256,59,198,0.23,428,0.598,29,0.642,6.5,316,85,232,0.269,628,0.503,39,0.537,7.0
52,201943,Brandon Jennings,1610612764,WAS,81,37,44,1801.0,29,6,22,0.207,117,0.248,7,0.264,13.4,167,17,153,0.102,315,0.53,29,0.584,9.6,196,23,175,0.117,432,0.454,36,0.495,10.1
53,202688,Brandon Knight,1610612756,PHX,53,16,37,1121.0,25,10,14,0.4,101,0.248,5,0.26,12.4,92,16,75,0.174,208,0.442,20,0.489,7.6,117,26,89,0.222,309,0.379,25,0.412,8.6
54,201575,Brandon Rush,1610612750,MIN,47,15,32,1030.0,16,6,9,0.375,57,0.281,6,0.314,13.0,83,16,66,0.193,175,0.474,13,0.512,7.6,99,22,75,0.222,232,0.427,19,0.465,8.4
55,203148,Brian Roberts,1610612766,CHA,41,16,25,416.0,5,3,2,0.6,28,0.179,1,0.185,10.1,34,4,30,0.118,60,0.567,5,0.618,9.6,39,7,32,0.179,88,0.443,6,0.476,9.6
56,1627362,Briante Weber,1610612766,CHA,20,12,8,205.0,8,2,5,0.25,23,0.348,0,0.348,9.2,18,1,17,0.056,34,0.529,2,0.563,6.0,26,3,22,0.115,57,0.456,2,0.473,6.9
57,1627744,Brice Johnson,1610612746,LAC,3,1,2,9.0,1,1,0,1.0,2,0.5,0,0.5,3.4,2,1,1,0.5,4,0.5,0,0.5,2.4,3,2,1,0.667,6,0.5,0,0.5,2.8
58,201572,Brook Lopez,1610612751,BKN,75,20,55,2222.0,121,87,33,0.719,287,0.422,6,0.431,6.6,282,122,160,0.433,554,0.509,47,0.556,6.5,403,209,193,0.519,840,0.48,53,0.512,6.5
59,203998,Bruno Caboclo,1610612761,TOR,8,7,1,38.0,4,3,1,0.75,5,0.8,0,0.8,3.1,5,2,3,0.4,7,0.714,1,0.833,3.7,9,5,4,0.556,12,0.75,1,0.818,3.4
60,1627854,Bryn Forbes,1610612759,SAS,35,24,11,280.0,2,0,1,0.0,14,0.143,2,0.167,19.6,20,3,18,0.15,45,0.444,5,0.5,10.4,22,3,19,0.136,58,0.379,7,0.431,10.8
61,1627741,Buddy Hield,1610612758,SAC,82,31,51,1888.0,35,10,24,0.286,152,0.23,6,0.24,11.2,234,29,206,0.124,424,0.552,33,0.598,7.8,269,39,230,0.145,576,0.467,39,0.501,8.3
62,201228,C.J. Watson,1610612753,ORL,62,20,42,1012.0,16,1,15,0.063,67,0.239,5,0.258,16.5,73,11,62,0.151,144,0.507,17,0.575,9.2,89,12,77,0.135,211,0.422,22,0.471,10.5
63,203468,CJ McCollum,1610612757,POR,80,40,40,2796.0,60,19,43,0.317,236,0.254,8,0.263,14.2,229,34,198,0.148,496,0.462,36,0.498,9.3,289,53,241,0.183,730,0.396,44,0.421,10.3
64,101139,CJ Miles,1610612754,IND,75,39,36,1756.0,28,12,16,0.429,93,0.301,4,0.315,13.0,197,43,155,0.218,313,0.629,20,0.672,8.2,225,55,171,0.244,406,0.554,24,0.589,8.8
65,203912,CJ Wilcox,1610612753,ORL,22,8,14,108.0,4,0,4,0.0,11,0.364,0,0.364,19.8,8,1,7,0.125,19,0.421,4,0.533,8.4,12,1,11,0.083,30,0.4,4,0.462,12.2
66,1626166,Cameron Payne,1610612741,CHI,31,16,15,462.0,3,1,2,0.333,36,0.083,0,0.083,8.9,45,2,44,0.044,83,0.542,5,0.577,8.4,48,3,46,0.063,119,0.403,5,0.421,8.4
67,1627747,Caris LeVert,1610612751,BKN,56,15,41,1218.0,23,9,12,0.391,88,0.261,4,0.274,13.7,164,23,141,0.14,255,0.643,16,0.686,7.1,187,32,153,0.171,343,0.545,20,0.579,7.8
68,2546,Carmelo Anthony,1610612752,NYK,74,29,45,2538.0,62,42,20,0.677,245,0.253,3,0.256,7.7,376,91,284,0.242,615,0.611,36,0.649,6.3,438,133,304,0.304,859,0.51,39,0.534,6.5
69,202718,Chandler Parsons,1610612763,MEM,34,18,16,675.0,6,3,4,0.5,38,0.158,1,0.162,7.4,78,16,64,0.205,124,0.629,9,0.678,7.7,84,19,68,0.226,162,0.519,10,0.553,7.8
70,101112,Channing Frye,1610612739,CLE,74,44,30,1398.0,37,21,16,0.568,107,0.346,3,0.356,9.5,253,99,152,0.391,458,0.552,40,0.605,5.1,290,120,168,0.414,564,0.514,43,0.557,5.6
71,1626184,Chasson Randle,1610612752,NYK,26,8,18,299.0,6,3,3,0.5,25,0.24,2,0.261,11.9,26,5,21,0.192,48,0.542,5,0.605,11.2,32,8,24,0.25,73,0.438,7,0.485,11.3
72,1627767,Cheick Diallo,1610612740,NOP,17,9,8,199.0,23,15,9,0.652,44,0.523,0,0.523,6.3,50,12,38,0.24,72,0.694,4,0.735,5.0,73,27,47,0.37,116,0.629,4,0.652,5.4
73,1627778,Chinanu Onuaku,1610612745,HOU,5,2,3,52.0,2,0,2,0.0,10,0.2,0,0.2,5.5,8,4,4,0.5,15,0.533,0,0.533,5.7,10,4,6,0.4,25,0.4,0,0.4,5.7
74,2365,Chris Andersen,1610612739,CLE,12,8,4,114.0,9,8,1,0.889,26,0.346,0,0.346,7.0,22,6,16,0.273,51,0.431,5,0.478,4.3,31,14,17,0.452,77,0.403,5,0.431,5.1
75,1626191,Chris McCullough,1610612764,WAS,16,1,15,80.0,9,4,5,0.444,18,0.5,0,0.5,7.5,10,1,9,0.1,22,0.455,2,0.5,4.0,19,5,14,0.263,40,0.475,2,0.5,5.7
76,101108,Chris Paul,1610612746,LAC,61,43,18,1921.0,40,17,25,0.425,136,0.294,6,0.308,15.7,264,32,234,0.121,498,0.53,29,0.563,8.0,304,49,259,0.161,634,0.479,35,0.508,9.1
77,1626174,Christian Wood,1610612766,CHA,13,5,8,107.0,14,11,3,0.786,24,0.583,0,0.583,4.0,15,3,12,0.2,36,0.417,5,0.484,5.1,29,14,15,0.483,60,0.483,5,0.527,4.6
78,203991,Clint Capela,1610612745,HOU,65,44,21,1551.0,178,125,48,0.702,400,0.445,11,0.458,6.2,348,134,212,0.385,584,0.596,34,0.633,4.7,526,259,260,0.492,983,0.535,45,0.561,5.2
79,203469,Cody Zeller,1610612766,CHA,62,33,29,1725.0,135,84,52,0.622,358,0.377,8,0.386,5.8,270,107,164,0.396,537,0.503,48,0.552,5.6,405,191,216,0.472,895,0.453,56,0.483,5.7
80,202332,Cole Aldrich,1610612750,MIN,62,23,39,531.0,51,29,21,0.569,105,0.486,2,0.495,7.4,107,43,61,0.402,177,0.605,11,0.645,4.6,158,72,82,0.456,281,0.562,13,0.59,5.5
81,201147,Corey Brewer,1610612747,LAL,82,47,35,1281.0,32,9,22,0.281,140,0.229,1,0.23,10.2,134,26,105,0.194,239,0.561,21,0.615,8.2,166,35,127,0.211,379,0.438,22,0.465,8.6
82,202709,Cory Joseph,1610612761,TOR,79,48,31,1977.0,50,26,25,0.52,211,0.237,7,0.245,10.6,178,45,135,0.253,412,0.432,46,0.486,7.8,228,71,160,0.311,623,0.366,53,0.4,8.5
83,201584,Courtney Lee,1610612752,NYK,77,29,48,2459.0,53,15,40,0.283,154,0.344,5,0.356,12.9,206,19,185,0.092,388,0.531,35,0.584,10.1,259,34,225,0.131,542,0.478,40,0.516,10.7
84,1626245,Cristiano Felicio,1610612741,CHI,66,31,35,1040.0,124,85,35,0.685,315,0.394,4,0.399,5.3,187,56,131,0.299,371,0.504,38,0.562,4.1,311,141,166,0.453,686,0.453,42,0.483,4.6
85,1626156,D'Angelo Russell,1610612747,LAL,63,21,42,1811.0,31,11,21,0.355,164,0.189,6,0.196,12.7,190,20,175,0.105,352,0.54,23,0.578,8.7,221,31,196,0.14,516,0.428,29,0.454,9.4
86,201571,D.J. Augustin,1610612753,ORL,78,29,49,1538.0,15,4,11,0.267,86,0.174,4,0.183,14.3,102,7,96,0.069,203,0.502,10,0.528,11.3,117,11,107,0.094,289,0.405,14,0.425,11.7
87,2563,Dahntay Jones,1610612739,CLE,1,0,1,12.0,1,1,0,1.0,2,0.5,0,0.5,4.2,1,0,1,0.0,2,0.5,0,0.5,4.3,2,1,1,0.5,4,0.5,0,0.5,4.3
88,1627745,Damian Jones,1610612744,GSW,10,7,3,85.0,9,4,5,0.444,23,0.391,1,0.409,6.4,14,4,10,0.286,23,0.609,1,0.636,5.3,23,8,15,0.348,46,0.5,2,0.523,5.7
89,203081,Damian Lillard,1610612757,POR,75,38,37,2693.0,46,22,22,0.478,225,0.204,11,0.215,10.7,322,54,271,0.168,606,0.531,54,0.583,8.7,368,76,293,0.207,831,0.443,65,0.48,8.9
90,204014,Damjan Rudez,1610612753,ORL,45,12,33,314.0,5,2,2,0.4,10,0.5,0,0.5,13.0,20,3,16,0.15,42,0.476,5,0.541,8.0,25,5,18,0.2,52,0.481,5,0.532,8.9
91,1627849,Daniel Ochefu,1610612764,WAS,19,12,7,75.0,5,2,3,0.4,23,0.217,0,0.217,5.9,17,7,10,0.412,20,0.85,1,0.895,4.3,22,9,13,0.409,43,0.512,1,0.524,4.6
92,201568,Danilo Gallinari,1610612743,DEN,62,30,32,2104.0,39,21,18,0.538,153,0.255,5,0.264,9.7,284,57,227,0.201,470,0.604,38,0.657,7.6,323,78,245,0.241,622,0.519,43,0.558,7.9
93,201980,Danny Green,1610612759,SAS,67,51,16,1778.0,31,13,17,0.419,98,0.316,1,0.32,12.4,191,48,145,0.251,407,0.469,38,0.518,6.2,222,61,162,0.275,505,0.44,39,0.476,7.1
94,201967,Dante Cunningham,1610612740,NOP,66,28,38,1649.0,56,31,23,0.554,126,0.444,3,0.455,7.1,221,45,175,0.204,391,0.565,29,0.61,5.7,277,76,198,0.274,516,0.537,32,0.572,6.0
95,203957,Dante Exum,1610612762,UTA,66,40,26,1228.0,30,9,20,0.3,90,0.333,1,0.337,15.6,102,16,86,0.157,197,0.518,12,0.551,8.5,132,25,106,0.189,287,0.46,13,0.482,10.1
96,1627863,Danuel House,1610612764,WAS,1,0,1,1.0,0,0,0,0.0,0,0.0,0,0.0,0.0,1,0,1,0.0,1,1.0,0,1.0,5.0,1,0,1,0.0,1,1.0,0,1.0,5.0
97,203967,Dario Saric,1610612755,PHI,81,28,53,2129.0,112,70,32,0.625,315,0.356,8,0.365,7.1,401,118,277,0.294,683,0.587,54,0.638,4.8,513,188,309,0.366,997,0.515,62,0.549,5.3
98,201589,Darrell Arthur,1610612743,DEN,41,20,21,639.0,25,18,7,0.72,60,0.417,4,0.446,8.4,87,25,59,0.287,166,0.524,15,0.576,6.7,112,43,66,0.384,226,0.496,19,0.541,7.1
99,201954,Darren Collison,1610612758,SAC,68,26,42,2063.0,23,8,15,0.348,130,0.177,5,0.184,16.1,129,11,119,0.085,260,0.496,23,0.544,11.4,152,19,134,0.125,390,0.39,28,0.42,12.1
100,1626199,Darrun Hilliard,1610612765,DET,39,19,20,381.0,2,1,1,0.5,22,0.091,2,0.1,13.5,31,6,25,0.194,56,0.554,6,0.62,9.1,33,7,26,0.212,77,0.429,8,0.478,9.4
101,101135,David Lee,1610612759,SAS,78,58,20,1464.0,148,98,48,0.662,326,0.454,10,0.468,6.1,290,96,193,0.331,503,0.577,40,0.626,4.8,438,194,241,0.443,826,0.53,50,0.564,5.2
102,1628021,David Nwaba,1610612747,LAL,20,5,15,397.0,17,9,9,0.529,62,0.274,2,0.283,5.2,46,10,36,0.217,86,0.535,11,0.613,7.8,63,19,45,0.302,148,0.426,13,0.467,7.3
103,2561,David West,1610612744,GSW,68,56,12,854.0,47,29,18,0.617,102,0.461,3,0.475,5.2,156,75,78,0.481,307,0.508,28,0.559,5.1,203,104,96,0.512,409,0.496,31,0.537,5.1
104,202722,Davis Bertans,1610612759,SAS,66,51,15,803.0,22,13,9,0.591,60,0.367,2,0.379,10.3,76,27,48,0.355,185,0.411,20,0.461,6.1,98,40,57,0.408,245,0.4,22,0.439,7.1
105,201599,DeAndre Jordan,1610612746,LAC,81,51,30,2570.0,298,207,84,0.695,570,0.523,10,0.532,4.9,816,254,558,0.311,1133,0.72,57,0.758,4.5,1114,461,642,0.414,1700,0.655,67,0.682,4.6
106,202732,DeAndre Liggins,1610612742,DAL,62,40,22,777.0,20,7,11,0.35,63,0.317,3,0.333,12.9,88,14,73,0.159,155,0.568,9,0.603,7.9,108,21,84,0.194,217,0.498,12,0.527,8.8
107,1627761,DeAndre' Bembry,1610612737,ATL,38,20,18,371.0,14,9,5,0.643,47,0.298,0,0.298,8.1,45,10,35,0.222,90,0.5,14,0.592,7.5,59,19,40,0.322,136,0.434,14,0.484,7.7
108,201942,DeMar DeRozan,1610612761,TOR,73,46,27,2591.0,70,34,34,0.486,248,0.282,9,0.293,11.1,315,62,251,0.197,504,0.625,27,0.66,7.9,385,96,285,0.249,751,0.513,36,0.538,8.5
109,202326,DeMarcus Cousins,1610612740,NOP,72,30,42,2465.0,152,111,30,0.73,436,0.349,10,0.357,5.5,642,194,440,0.302,894,0.718,51,0.762,4.5,794,305,470,0.384,1322,0.601,61,0.63,4.7
110,201960,DeMarre Carroll,1610612761,TOR,71,43,28,1860.0,62,36,23,0.581,209,0.297,12,0.315,8.4,210,48,161,0.229,412,0.51,37,0.56,7.1,272,84,184,0.309,619,0.439,49,0.477,7.4
111,1627749,Dejounte Murray,1610612759,SAS,38,29,9,321.0,6,3,3,0.5,30,0.2,2,0.214,15.0,36,9,27,0.25,81,0.444,9,0.5,6.6,42,12,30,0.286,111,0.378,11,0.42,7.8
112,1626153,Delon Wright,1610612761,TOR,27,19,8,446.0,16,4,12,0.25,53,0.302,1,0.308,9.4,32,10,22,0.313,68,0.471,6,0.516,9.0,48,14,34,0.292,121,0.397,7,0.421,9.1
113,1627743,Demetrius Jackson,1610612738,BOS,5,1,4,17.0,2,1,1,0.5,3,0.667,0,0.667,17.9,2,0,2,0.0,5,0.4,0,0.4,14.0,4,1,3,0.25,8,0.5,0,0.5,15.9
114,203471,Dennis Schroder,1610612737,ATL,79,42,37,2485.0,42,15,27,0.357,243,0.173,12,0.182,13.7,206,26,181,0.126,416,0.495,46,0.557,10.8,248,41,208,0.165,659,0.376,58,0.413,11.4
115,1627756,Denzel Valentine,1610612741,CHI,57,28,29,977.0,11,2,9,0.182,50,0.22,1,0.224,17.0,140,32,106,0.229,259,0.541,24,0.596,7.0,151,34,115,0.225,309,0.489,25,0.532,7.8
116,101114,Deron Williams,1610612739,CLE,63,24,39,1625.0,13,6,8,0.462,87,0.149,4,0.157,18.6,132,13,119,0.098,263,0.502,22,0.548,10.1,145,19,127,0.131,350,0.414,26,0.448,11.0
117,202324,Derrick Favors,1610612762,UTA,50,33,17,1186.0,92,61,29,0.663,218,0.422,8,0.438,5.4,213,81,130,0.38,378,0.563,37,0.625,4.6,305,142,159,0.466,593,0.514,45,0.557,4.9
118,1627884,Derrick Jones Jr.,1610612756,PHX,32,7,25,545.0,39,24,14,0.615,71,0.549,0,0.549,7.6,40,12,28,0.3,85,0.471,6,0.506,6.7,79,36,42,0.456,156,0.506,6,0.527,7.1
119,201565,Derrick Rose,1610612752,NYK,64,26,38,2082.0,66,29,36,0.439,257,0.257,22,0.281,11.0,180,23,157,0.128,338,0.533,25,0.575,10.4,246,52,193,0.211,595,0.413,47,0.449,10.6
120,202682,Derrick Williams,1610612739,CLE,50,16,34,804.0,19,14,6,0.737,50,0.38,1,0.388,6.4,111,20,92,0.18,176,0.631,16,0.694,5.4,130,34,98,0.262,226,0.575,17,0.622,5.6
121,1626164,Devin Booker,1610612756,PHX,76,23,53,2656.0,44,19,26,0.432,228,0.193,8,0.2,12.4,202,33,171,0.163,420,0.481,36,0.526,9.0,246,52,197,0.211,648,0.38,44,0.407,9.6
122,2734,Devin Harris,1610612742,DAL,64,28,36,1071.0,11,3,7,0.273,68,0.162,6,0.177,9.3,115,19,96,0.165,211,0.545,20,0.602,8.2,126,22,103,0.175,279,0.452,26,0.498,8.5
123,203473,Dewayne Dedmon,1610612759,SAS,75,55,20,1316.0,128,91,35,0.711,300,0.427,6,0.435,5.8,365,118,246,0.323,513,0.712,27,0.751,4.5,493,209,281,0.424,810,0.609,33,0.634,4.9
124,1627738,Deyonta Davis,1610612763,MEM,36,23,13,238.0,20,12,8,0.6,52,0.385,2,0.4,5.2,40,17,23,0.425,73,0.548,3,0.571,5.8,60,29,31,0.483,125,0.48,5,0.5,5.6
125,1627754,Diamond Stone,1610612746,LAC,7,6,1,24.0,1,0,1,0.0,12,0.083,1,0.091,9.5,5,1,4,0.2,10,0.5,0,0.5,5.6,6,1,5,0.167,21,0.286,1,0.3,6.2
126,203079,Dion Waiters,1610612748,MIA,46,27,19,1384.0,18,8,10,0.444,118,0.153,7,0.162,11.4,135,25,112,0.185,285,0.474,23,0.515,8.9,153,33,122,0.216,401,0.382,30,0.412,9.2
127,1717,Dirk Nowitzki,1610612742,DAL,53,22,31,1394.0,23,11,11,0.478,66,0.348,6,0.383,10.4,324,120,202,0.37,478,0.678,34,0.73,4.4,347,131,213,0.378,542,0.64,40,0.691,4.8
128,1627734,Domantas Sabonis,1610612760,OKC,81,46,35,1631.0,46,27,17,0.587,170,0.271,8,0.284,7.4,242,87,154,0.36,442,0.548,31,0.589,5.5,288,114,171,0.396,610,0.472,39,0.504,5.8
129,202700,Donatas Motiejunas,1610612740,NOP,34,16,18,479.0,26,15,11,0.577,64,0.406,0,0.406,6.8,75,29,47,0.387,142,0.528,10,0.568,4.8,101,44,58,0.436,206,0.49,10,0.515,5.3
130,1627827,Dorian Finney-Smith,1610612742,DAL,80,32,48,1632.0,54,31,22,0.574,149,0.362,7,0.38,9.4,167,50,116,0.299,320,0.522,16,0.549,6.2,221,81,138,0.367,468,0.472,23,0.497,6.9
131,203926,Doug McDermott,1610612760,OKC,66,35,31,1508.0,20,10,11,0.5,98,0.204,6,0.217,14.4,159,49,111,0.308,305,0.521,44,0.609,5.2,179,59,122,0.33,403,0.444,50,0.507,6.3
132,1627733,Dragan Bender,1610612756,PHX,41,12,29,545.0,22,11,10,0.5,46,0.478,3,0.512,9.3,74,21,53,0.284,138,0.536,5,0.556,5.4,96,32,63,0.333,182,0.527,8,0.552,6.2
133,203110,Draymond Green,1610612744,GSW,76,62,14,2471.0,98,61,36,0.622,252,0.389,13,0.41,6.5,501,171,326,0.341,835,0.6,66,0.651,4.6,599,232,362,0.387,1082,0.554,79,0.597,4.9
134,2730,Dwight Howard,1610612737,ATL,74,37,37,2199.0,296,211,76,0.713,650,0.455,7,0.46,4.2,644,223,416,0.346,1003,0.642,60,0.683,4.0,940,434,492,0.462,1652,0.569,67,0.593,4.0
135,203939,Dwight Powell,1610612742,DAL,76,29,47,1318.0,90,50,39,0.556,252,0.357,9,0.37,7.1,211,58,151,0.275,353,0.598,35,0.664,4.8,301,108,190,0.359,605,0.498,44,0.537,5.4
136,2548,Dwyane Wade,1610612741,CHI,60,29,31,1792.0,63,32,29,0.508,189,0.333,8,0.348,7.3,207,40,165,0.193,362,0.572,24,0.612,6.5,270,72,194,0.267,551,0.49,32,0.52,6.7
137,202734,E'Twaun Moore,1610612740,NOP,73,32,41,1820.0,33,12,19,0.364,91,0.363,1,0.367,11.9,119,24,93,0.202,257,0.463,26,0.515,9.9,152,36,112,0.237,348,0.437,27,0.474,10.4
138,202334,Ed Davis,1610612757,POR,46,19,27,789.0,96,68,25,0.708,242,0.397,10,0.414,4.9,148,55,92,0.372,286,0.517,25,0.567,4.9,244,123,117,0.504,528,0.462,35,0.495,4.9
139,204002,Edy Tavares,1610612739,CLE,2,1,1,28.0,4,2,2,0.5,8,0.5,0,0.5,9.4,7,6,1,0.857,12,0.583,0,0.583,4.3,11,8,3,0.727,20,0.55,0,0.55,6.1
140,203901,Elfrid Payton,1610612753,ORL,82,29,53,2412.0,89,41,47,0.461,319,0.279,16,0.294,9.4,298,35,265,0.117,509,0.585,46,0.644,8.7,387,76,312,0.196,828,0.467,62,0.505,8.9
141,202407,Elijah Millsap,1610612756,PHX,2,1,1,23.0,3,1,2,0.333,4,0.75,0,0.75,11.3,3,0,3,0.0,11,0.273,2,0.333,5.0,6,1,5,0.167,15,0.4,2,0.462,8.2
142,1626144,Emmanuel Mudiay,1610612743,DEN,54,24,30,1384.0,29,9,20,0.31,145,0.2,9,0.213,13.0,147,17,131,0.116,262,0.561,21,0.61,8.6,176,26,151,0.148,407,0.432,30,0.467,9.3
143,202683,Enes Kanter,1610612760,OKC,72,43,29,1533.0,195,149,38,0.764,494,0.395,14,0.406,4.2,287,92,193,0.321,508,0.565,49,0.625,4.6,482,241,231,0.5,1000,0.482,63,0.514,4.4
144,202339,Eric Bledsoe,1610612756,PHX,64,21,43,2110.0,49,27,21,0.551,230,0.213,15,0.228,10.4,259,41,218,0.158,444,0.583,35,0.633,8.5,308,68,239,0.221,673,0.458,50,0.494,8.8
145,201569,Eric Gordon,1610612745,HOU,75,50,25,2323.0,29,8,21,0.276,186,0.156,4,0.159,16.5,172,32,140,0.186,397,0.433,31,0.47,9.3,201,40,161,0.199,583,0.345,35,0.367,10.4
146,101141,Ersan Ilyasova,1610612737,ATL,82,35,47,2142.0,115,84,30,0.73,329,0.35,7,0.357,6.3,366,114,249,0.311,609,0.601,49,0.654,5.5,481,198,279,0.412,938,0.513,56,0.545,5.7
147,203095,Evan Fournier,1610612753,ORL,68,23,45,2234.0,44,20,22,0.455,192,0.229,4,0.234,11.7,165,36,127,0.218,359,0.46,44,0.524,8.5,209,56,149,0.268,549,0.381,48,0.417,9.1
148,202323,Evan Turner,1610612757,POR,65,34,31,1659.0,36,18,18,0.5,150,0.24,0,0.24,9.7,211,42,166,0.199,405,0.521,44,0.584,6.6,247,60,184,0.243,555,0.445,44,0.483,7.1
149,1626163,Frank Kaminsky,1610612766,CHA,75,31,44,1954.0,57,36,21,0.632,182,0.313,10,0.331,8.5,279,81,198,0.29,527,0.529,49,0.584,5.8,336,117,219,0.348,708,0.475,59,0.518,6.3
150,1627832,Fred VanVleet,1610612761,TOR,36,24,12,292.0,4,1,4,0.25,27,0.148,1,0.154,17.2,38,4,34,0.105,59,0.644,2,0.667,8.7,42,5,38,0.119,85,0.494,3,0.512,9.6
151,202066,Garrett Temple,1610612758,SAC,65,25,40,1728.0,32,11,21,0.344,131,0.244,4,0.252,12.3,152,45,106,0.296,297,0.512,18,0.545,9.1,184,56,127,0.304,428,0.43,22,0.453,9.7
152,203914,Gary Harris,1610612743,DEN,56,28,28,1748.0,48,24,24,0.5,155,0.31,8,0.327,10.2,125,22,103,0.176,235,0.532,22,0.587,9.0,173,46,127,0.266,390,0.444,30,0.481,9.3
153,202390,Gary Neal,1610612737,ATL,2,1,1,18.0,0,0,0,0.0,0,0.0,0,0.0,0.0,1,0,1,0.0,2,0.5,0,0.5,9.8,1,0,1,0.0,2,0.5,0,0.5,9.8
154,1627780,Gary Payton II,1610612749,MIL,6,2,4,99.0,0,0,0,0.0,7,0.0,2,0.0,0.0,12,1,11,0.083,22,0.545,1,0.571,8.0,12,1,11,0.083,29,0.414,3,0.462,8.0
155,201588,George Hill,1610612762,UTA,49,33,16,1544.0,23,10,14,0.435,87,0.264,1,0.267,12.1,144,33,116,0.229,290,0.497,30,0.554,7.8,167,43,130,0.257,377,0.443,31,0.483,8.4
156,1627777,Georges Niang,1610612754,IND,22,11,11,90.0,2,0,2,0.0,12,0.167,1,0.182,9.6,15,3,12,0.2,29,0.517,5,0.625,7.7,17,3,14,0.176,41,0.415,6,0.486,7.9
157,1627834,Georgios Papagiannis,1610612758,SAC,22,7,15,355.0,24,14,7,0.583,42,0.571,0,0.571,4.9,62,20,42,0.323,102,0.608,11,0.681,4.3,86,34,49,0.395,144,0.597,11,0.647,4.5
158,101123,Gerald Green,1610612738,BOS,47,32,15,538.0,16,8,8,0.5,53,0.302,4,0.327,13.9,68,9,58,0.132,120,0.567,11,0.624,7.3,84,17,66,0.202,173,0.486,15,0.532,8.5
159,201945,Gerald Henderson,1610612755,PHI,72,24,48,1667.0,34,13,22,0.382,134,0.254,4,0.262,13.2,151,28,120,0.185,266,0.568,12,0.594,8.8,185,41,142,0.222,400,0.463,16,0.482,9.7
160,203507,Giannis Antetokounmpo,1610612749,MIL,80,42,38,2845.0,142,101,39,0.711,390,0.364,11,0.375,6.4,558,137,415,0.246,849,0.657,59,0.706,6.4,700,238,454,0.34,1238,0.565,70,0.599,6.4
161,203922,Glenn Robinson III,1610612754,IND,68,35,33,1399.0,53,22,32,0.415,155,0.342,1,0.344,10.8,189,36,154,0.19,350,0.54,35,0.6,6.8,242,58,186,0.24,505,0.479,36,0.516,7.7
162,201609,Goran Dragic,1610612748,MIA,73,40,33,2459.0,62,20,40,0.323,282,0.22,8,0.226,12.3,217,32,188,0.147,469,0.463,40,0.506,8.9,279,52,228,0.186,750,0.372,48,0.397,9.6
163,202330,Gordon Hayward,1610612762,UTA,73,46,27,2516.0,49,26,25,0.531,180,0.272,5,0.28,11.9,345,56,286,0.162,542,0.637,40,0.687,7.2,394,82,311,0.208,722,0.546,45,0.582,7.8
164,203476,Gorgui Dieng,1610612750,MIN,82,31,51,2653.0,188,113,72,0.601,454,0.414,12,0.425,7.1,459,134,323,0.292,792,0.58,72,0.638,5.1,647,247,395,0.382,1242,0.521,84,0.559,5.6
165,202328,Greg Monroe,1610612749,MIL,81,42,39,1823.0,167,134,31,0.802,418,0.4,10,0.409,4.9,365,134,231,0.367,590,0.619,52,0.678,4.8,532,268,262,0.504,1007,0.528,62,0.563,4.9
166,202349,Greivis Vasquez,1610612751,BKN,3,1,2,39.0,0,0,1,0.0,2,0.0,0,0.0,0.0,2,0,2,0.0,5,0.4,1,0.5,6.5,2,0,3,0.0,7,0.286,1,0.333,6.5
167,203084,Harrison Barnes,1610612742,DAL,78,31,47,2767.0,92,47,44,0.511,257,0.358,11,0.374,8.7,298,88,209,0.295,574,0.519,53,0.572,6.5,390,135,253,0.346,829,0.47,64,0.51,7.0
168,202355,Hassan Whiteside,1610612748,MIA,77,39,38,2513.0,293,221,64,0.754,665,0.441,19,0.454,4.6,795,304,483,0.382,1187,0.67,73,0.714,3.6,1088,525,547,0.483,1850,0.588,92,0.619,3.8
169,1627740,Henry Ellenson,1610612765,DET,19,8,11,146.0,8,4,4,0.5,16,0.5,0,0.5,3.9,33,6,27,0.182,48,0.688,4,0.75,4.8,41,10,31,0.244,64,0.641,4,0.683,4.6
170,203138,Hollis Thompson,1610612740,NOP,40,12,28,752.0,19,8,9,0.421,52,0.365,1,0.373,12.3,93,18,73,0.194,159,0.585,12,0.633,7.0,112,26,82,0.232,211,0.531,13,0.566,7.8
171,203546,Ian Clark,1610612744,GSW,77,63,14,1137.0,22,5,17,0.227,90,0.244,4,0.256,13.4,99,11,90,0.111,185,0.535,22,0.607,9.5,121,16,107,0.132,275,0.44,26,0.486,10.3
172,101133,Ian Mahinmi,1610612764,WAS,31,19,12,555.0,47,24,23,0.511,120,0.392,4,0.405,6.7,103,34,66,0.33,177,0.582,22,0.665,5.1,150,58,89,0.387,297,0.505,26,0.554,5.6
173,202697,Iman Shumpert,1610612739,CLE,76,48,28,1937.0,39,13,26,0.333,119,0.328,6,0.345,13.5,179,34,146,0.19,333,0.538,25,0.581,7.8,218,47,172,0.216,452,0.482,31,0.518,8.8
174,203477,Isaiah Canaan,1610612741,CHI,39,19,20,592.0,6,2,4,0.333,36,0.167,3,0.182,9.0,44,5,39,0.114,84,0.524,7,0.571,8.7,50,7,43,0.14,120,0.417,10,0.455,8.8
175,1627819,Isaiah Taylor,1610612745,HOU,4,3,1,52.0,1,1,0,1.0,3,0.333,0,0.333,11.3,2,0,2,0.0,4,0.5,0,0.5,15.1,3,1,2,0.333,7,0.429,0,0.429,13.8
176,202738,Isaiah Thomas,1610612738,BOS,76,51,25,2569.0,42,18,25,0.429,267,0.157,15,0.167,14.1,162,19,145,0.117,341,0.475,17,0.5,11.6,204,37,170,0.181,608,0.336,32,0.354,12.1
177,1627785,Isaiah Whitehead,1610612751,BKN,73,17,56,1643.0,32,21,11,0.656,139,0.23,7,0.242,9.5,152,32,120,0.211,313,0.486,33,0.543,8.7,184,53,131,0.288,452,0.407,40,0.447,8.9
178,202397,Ish Smith,1610612765,DET,81,37,44,1955.0,21,3,19,0.143,119,0.176,4,0.183,17.6,214,30,185,0.14,459,0.466,68,0.547,8.1,235,33,204,0.14,578,0.407,72,0.464,9.1
179,1627826,Ivica Zubac,1610612747,LAL,38,8,30,609.0,41,29,11,0.707,110,0.373,2,0.38,4.2,118,52,65,0.441,227,0.52,19,0.567,4.9,159,81,76,0.509,337,0.472,21,0.503,4.8
180,200826,J.J. Barea,1610612742,DAL,34,10,24,751.0,9,1,8,0.111,45,0.2,0,0.2,18.1,74,6,68,0.081,144,0.514,15,0.574,8.9,83,7,76,0.084,189,0.439,15,0.477,9.9
181,200755,JJ Redick,1610612746,LAC,78,50,28,2198.0,11,1,10,0.091,63,0.175,2,0.18,16.6,160,19,138,0.119,325,0.492,40,0.561,9.1,171,20,148,0.117,387,0.442,42,0.496,9.5
182,2747,JR Smith,1610612739,CLE,41,25,16,1187.0,17,6,12,0.353,48,0.354,1,0.362,16.5,96,19,78,0.198,163,0.589,15,0.649,9.6,113,25,90,0.221,210,0.538,16,0.582,10.7
183,203210,JaMychal Green,1610612763,MEM,77,40,37,2101.0,167,120,44,0.719,358,0.466,8,0.477,5.8,377,111,263,0.294,571,0.66,41,0.711,5.1,544,231,307,0.425,925,0.588,49,0.621,5.3
184,201580,JaVale McGee,1610612744,GSW,77,62,15,739.0,100,67,31,0.67,200,0.5,5,0.513,5.2,144,62,76,0.431,261,0.552,30,0.623,4.4,244,129,107,0.529,461,0.529,35,0.573,4.7
185,203953,Jabari Parker,1610612749,MIL,51,22,29,1728.0,79,44,29,0.557,234,0.338,7,0.348,7.5,235,62,169,0.264,414,0.568,34,0.618,6.4,314,106,198,0.338,648,0.485,41,0.517,6.7
186,203109,Jae Crowder,1610612738,BOS,72,48,24,2335.0,48,14,36,0.292,203,0.236,5,0.242,10.9,367,78,288,0.213,555,0.661,33,0.703,6.9,415,92,324,0.222,754,0.55,38,0.58,7.4
187,1626143,Jahlil Okafor,1610612755,PHI,50,15,35,1134.0,81,61,18,0.753,251,0.323,5,0.329,5.7,159,60,101,0.377,324,0.491,38,0.556,4.9,240,121,119,0.504,574,0.418,43,0.452,5.2
188,1627774,Jake Layman,1610612757,POR,35,16,19,249.0,6,4,3,0.667,18,0.333,0,0.333,7.6,18,6,12,0.333,38,0.474,4,0.529,7.3,24,10,15,0.417,56,0.429,4,0.462,7.4
189,1627751,Jakob Poeltl,1610612761,TOR,53,37,16,621.0,77,55,20,0.714,171,0.45,6,0.467,4.7,86,34,51,0.395,178,0.483,22,0.551,4.4,163,89,71,0.546,348,0.468,28,0.509,4.6
190,2037,Jamal Crawford,1610612746,LAC,82,51,31,2157.0,17,7,9,0.412,73,0.233,3,0.243,12.3,112,16,98,0.143,225,0.498,14,0.531,11.8,129,23,107,0.178,298,0.433,17,0.459,11.9
191,1627750,Jamal Murray,1610612743,DEN,81,39,42,1754.0,40,10,29,0.25,154,0.26,6,0.27,14.8,173,36,135,0.208,287,0.603,28,0.668,8.7,213,46,164,0.216,441,0.483,34,0.523,9.8
192,2749,Jameer Nelson,1610612743,DEN,74,33,41,2021.0,28,13,15,0.464,104,0.269,7,0.289,16.4,164,23,140,0.14,309,0.531,26,0.58,9.7,192,36,155,0.188,413,0.465,33,0.505,10.6
193,203516,James Ennis III,1610612763,MEM,64,32,32,1501.0,69,43,24,0.623,192,0.359,5,0.369,8.6,190,45,143,0.237,305,0.623,24,0.676,6.3,259,88,167,0.34,496,0.522,29,0.555,6.9
194,201935,James Harden,1610612745,HOU,81,54,27,2947.0,95,53,42,0.558,260,0.365,7,0.375,10.9,564,115,444,0.204,854,0.66,56,0.707,6.2,659,168,486,0.255,1113,0.592,63,0.628,6.9
195,201949,James Johnson,1610612748,MIA,76,40,36,2085.0,66,27,38,0.409,226,0.292,8,0.303,8.3,310,77,228,0.248,520,0.596,44,0.651,6.0,376,104,266,0.277,745,0.505,52,0.543,6.4
196,2592,James Jones,1610612739,CLE,48,28,20,381.0,3,1,2,0.333,17,0.176,1,0.188,13.0,34,12,22,0.353,90,0.378,10,0.425,6.2,37,13,24,0.351,107,0.346,11,0.385,6.8
197,203949,James Michael McAdoo,1610612744,GSW,52,43,9,457.0,34,19,13,0.559,100,0.34,3,0.351,7.6,57,19,38,0.333,135,0.422,16,0.479,6.6,91,38,51,0.418,235,0.387,19,0.421,7.0
198,203923,James Young,1610612738,BOS,29,16,13,220.0,6,5,1,0.833,14,0.429,0,0.429,10.0,20,6,14,0.3,41,0.488,3,0.526,5.4,26,11,15,0.423,55,0.473,3,0.5,6.5
199,201162,Jared Dudley,1610612756,PHX,64,17,47,1362.0,31,15,17,0.484,127,0.244,5,0.254,12.2,194,47,142,0.242,457,0.425,45,0.471,6.6,225,62,159,0.276,584,0.385,50,0.421,7.4
200,203096,Jared Sullinger,1610612761,TOR,11,2,9,118.0,10,4,6,0.4,34,0.294,2,0.313,9.1,17,3,14,0.176,38,0.447,5,0.515,4.3,27,7,20,0.259,71,0.38,7,0.422,6.1
201,204067,Jarell Eddie,1610612756,PHX,5,0,5,62.0,1,1,0,1.0,4,0.25,0,0.25,2.5,6,1,5,0.167,15,0.4,0,0.4,11.7,7,2,5,0.286,19,0.368,0,0.368,10.3
202,1626185,Jarell Martin,1610612763,MEM,42,23,19,558.0,42,29,13,0.69,123,0.341,8,0.365,5.5,120,36,84,0.3,194,0.619,20,0.69,4.9,162,65,97,0.401,317,0.511,28,0.561,5.1
203,203950,Jarnell Stokes,1610612743,DEN,2,0,2,7.0,1,0,1,0.0,4,0.25,0,0.25,4.9,1,0,1,0.0,2,0.5,1,1.0,5.0,2,0,2,0.0,6,0.333,1,0.4,4.9
204,101127,Jarrett Jack,1610612740,NOP,2,1,1,33.0,0,0,0,0.0,2,0.0,0,0.0,0.0,0,0,0,0.0,2,0.0,1,0.0,0.0,0,0,0,0.0,4,0.0,1,0.0,0.0
205,1627784,Jarrod Uthoff,1610612742,DAL,9,2,7,115.0,8,3,5,0.375,22,0.364,0,0.364,8.3,14,3,11,0.214,32,0.438,5,0.519,8.0,22,6,16,0.273,54,0.407,5,0.449,8.1
206,201160,Jason Smith,1610612764,WAS,74,45,29,1068.0,64,33,30,0.516,161,0.398,3,0.405,8.3,194,68,123,0.351,344,0.564,25,0.608,5.6,258,101,153,0.391,505,0.511,28,0.541,6.3
207,1891,Jason Terry,1610612749,MIL,74,37,37,1365.0,15,1,13,0.067,44,0.341,2,0.357,18.5,91,11,82,0.121,170,0.535,9,0.565,11.1,106,12,95,0.113,214,0.495,11,0.522,12.1
208,1627759,Jaylen Brown,1610612738,BOS,78,50,28,1341.0,45,28,14,0.622,164,0.274,4,0.281,6.4,175,42,130,0.24,278,0.629,24,0.689,5.9,220,70,144,0.318,441,0.499,28,0.533,6.0
209,201145,Jeff Green,1610612753,ORL,69,26,43,1534.0,39,20,17,0.513,153,0.255,4,0.262,11.1,175,47,127,0.269,303,0.578,19,0.616,7.0,214,67,144,0.313,455,0.47,23,0.495,7.7
210,201952,Jeff Teague,1610612754,IND,81,42,39,2632.0,33,11,23,0.333,181,0.182,6,0.189,14.0,294,37,252,0.126,488,0.602,25,0.635,9.1,327,48,275,0.147,668,0.49,31,0.513,9.6
211,203481,Jeff Withey,1610612762,UTA,51,33,18,432.0,52,37,12,0.712,103,0.505,2,0.515,4.1,69,24,45,0.348,178,0.388,21,0.439,4.1,121,61,57,0.504,281,0.431,23,0.469,4.1
212,203924,Jerami Grant,1610612760,OKC,80,43,37,1531.0,38,16,21,0.421,119,0.319,2,0.325,9.7,167,65,103,0.389,347,0.481,27,0.522,6.7,205,81,124,0.395,465,0.441,29,0.47,7.2
213,203087,Jeremy Lamb,1610612766,CHA,62,27,35,1143.0,30,17,14,0.567,92,0.326,2,0.333,7.0,234,45,189,0.192,350,0.669,14,0.696,5.0,264,62,203,0.235,441,0.599,16,0.621,5.2
214,202391,Jeremy Lin,1610612751,BKN,35,13,22,858.0,11,3,8,0.273,73,0.151,3,0.157,16.2,122,18,104,0.148,248,0.492,18,0.53,7.7,133,21,112,0.158,320,0.416,21,0.445,8.4
215,1626170,Jerian Grant,1610612741,CHI,63,29,34,1028.0,17,5,13,0.294,78,0.218,2,0.224,16.1,94,14,80,0.149,206,0.456,21,0.508,7.7,111,19,93,0.171,284,0.391,23,0.425,9.1
216,201573,Jerryd Bayless,1610612755,PHI,3,1,2,71.0,3,2,1,0.667,10,0.3,1,0.333,19.5,9,1,8,0.111,13,0.692,1,0.75,7.7,12,3,9,0.25,23,0.522,2,0.571,10.7
217,202710,Jimmy Butler,1610612741,CHI,76,40,36,2809.0,129,69,59,0.535,333,0.387,5,0.393,9.5,341,62,285,0.182,600,0.568,42,0.611,8.0,470,131,344,0.279,933,0.504,47,0.53,8.4
218,201149,Joakim Noah,1610612752,NYK,46,17,29,1015.0,162,118,40,0.728,333,0.486,7,0.497,5.3,241,69,170,0.286,443,0.544,35,0.591,4.1,403,187,210,0.464,776,0.519,42,0.549,4.6
219,201975,Jodie Meeks,1610612753,ORL,36,14,22,738.0,5,2,3,0.4,31,0.161,2,0.172,14.8,72,17,55,0.236,127,0.567,12,0.626,7.8,77,19,58,0.247,158,0.487,14,0.535,8.3
220,203925,Joe Harris,1610612751,BKN,51,10,41,1116.0,16,7,9,0.438,87,0.184,6,0.198,10.3,125,20,103,0.16,247,0.506,27,0.568,7.7,141,27,112,0.191,334,0.422,33,0.468,8.0
221,204060,Joe Ingles,1610612762,UTA,82,51,31,1972.0,23,9,12,0.391,86,0.267,4,0.28,16.3,238,40,199,0.168,372,0.64,16,0.669,8.4,261,49,211,0.188,458,0.57,20,0.596,9.0
222,2207,Joe Johnson,1610612762,UTA,78,47,31,1843.0,33,15,18,0.455,96,0.344,1,0.347,10.0,210,44,165,0.21,354,0.593,28,0.644,7.4,243,59,183,0.243,449,0.541,29,0.579,7.7
223,1626202,Joe Young,1610612754,IND,32,18,14,132.0,1,0,1,0.0,17,0.059,1,0.063,14.7,16,0,16,0.0,24,0.667,1,0.696,9.3,17,0,17,0.0,39,0.436,2,0.459,9.6
224,201202,Joel Anthony,1610612759,SAS,19,15,4,122.0,8,6,1,0.75,30,0.267,1,0.276,5.6,23,10,13,0.435,35,0.657,3,0.719,5.2,31,16,14,0.516,65,0.477,4,0.508,5.3
225,1627762,Joel Bolomboy,1610612762,UTA,12,8,4,53.0,4,2,1,0.5,8,0.5,0,0.5,5.4,13,4,9,0.308,24,0.542,2,0.591,4.4,17,6,10,0.353,32,0.531,2,0.567,4.6
226,203954,Joel Embiid,1610612755,PHI,31,13,18,786.0,61,40,17,0.656,174,0.351,3,0.357,6.8,182,72,112,0.396,300,0.607,29,0.672,4.2,243,112,129,0.461,472,0.515,32,0.552,4.8
227,203530,Joffrey Lauvergne,1610612741,CHI,70,41,29,980.0,72,46,24,0.639,183,0.393,5,0.404,6.1,179,61,118,0.341,297,0.603,25,0.658,4.4,251,107,142,0.426,480,0.523,30,0.558,4.9
228,203089,John Henson,1610612749,MIL,58,26,32,1122.0,92,61,29,0.663,205,0.449,3,0.455,5.4,203,78,123,0.384,340,0.597,19,0.632,5.5,295,139,152,0.471,541,0.545,22,0.568,5.5
229,203098,John Jenkins,1610612756,PHX,4,0,4,13.0,0,0,0,0.0,0,0.0,0,0.0,0.0,1,0,1,0.0,3,0.333,1,0.5,10.1,1,0,1,0.0,3,0.333,1,0.5,10.1
230,101249,John Lucas III,1610612750,MIN,5,3,2,11.0,0,0,0,0.0,0,0.0,0,0.0,0.0,0,0,0,0.0,0,0.0,0,0.0,0.0,0,0,0,0.0,0,0.0,0,0.0,0.0
231,202322,John Wall,1610612764,WAS,78,48,30,2836.0,59,21,35,0.356,311,0.19,28,0.208,13.4,267,34,238,0.127,479,0.557,25,0.588,11.1,326,55,273,0.169,790,0.413,53,0.442,11.5
232,203948,Johnny O'Bryant III,1610612766,CHA,11,4,7,81.0,9,5,3,0.556,15,0.6,1,0.643,8.8,10,5,6,0.5,17,0.588,2,0.667,5.3,19,10,9,0.526,32,0.594,3,0.655,6.8
233,202720,Jon Leuer,1610612765,DET,75,34,41,1944.0,102,68,31,0.667,246,0.415,8,0.429,6.0,300,86,217,0.287,516,0.581,56,0.652,4.7,402,154,248,0.383,760,0.529,64,0.578,5.0
234,201973,Jonas Jerebko,1610612738,BOS,78,51,27,1232.0,59,28,31,0.475,175,0.337,3,0.343,8.3,213,52,160,0.244,371,0.574,26,0.617,4.8,272,80,191,0.294,544,0.5,29,0.528,5.5
235,202685,Jonas Valanciunas,1610612761,TOR,79,49,30,2043.0,223,173,37,0.776,515,0.433,13,0.444,4.2,522,217,305,0.416,854,0.611,61,0.658,3.5,745,390,342,0.523,1367,0.545,74,0.576,3.7
236,1626780,Jonathan Gibson,1610612742,DAL,17,4,13,231.0,1,1,0,1.0,15,0.067,1,0.071,4.4,21,2,19,0.095,34,0.618,1,0.636,10.3,22,3,19,0.136,49,0.449,2,0.468,10.0
237,203613,Jonathon Simmons,1610612759,SAS,77,60,17,1376.0,20,9,11,0.45,102,0.196,3,0.202,10.6,137,29,107,0.212,258,0.531,20,0.576,7.9,157,38,118,0.242,358,0.439,23,0.469,8.2
238,203903,Jordan Clarkson,1610612747,LAL,82,26,56,2397.0,49,19,29,0.388,242,0.202,10,0.211,12.1,197,17,181,0.086,376,0.524,20,0.553,10.1,246,36,210,0.146,618,0.398,30,0.418,10.5
239,202348,Jordan Crawford,1610612740,NOP,19,9,10,442.0,4,0,4,0.0,17,0.235,0,0.235,11.8,30,5,25,0.167,55,0.545,3,0.577,8.4,34,5,29,0.147,72,0.472,3,0.493,8.8
240,200770,Jordan Farmar,1610612758,SAC,2,1,1,35.0,1,0,1,0.0,1,1.0,0,1.0,19.0,2,0,2,0.0,7,0.286,1,0.333,10.4,3,0,3,0.0,8,0.375,1,0.429,13.2
241,201941,Jordan Hill,1610612750,MIN,7,2,5,47.0,8,5,3,0.625,10,0.8,0,0.8,5.3,6,1,5,0.167,17,0.353,3,0.429,5.1,14,6,8,0.429,27,0.519,3,0.583,5.2
242,203895,Jordan McRae,1610612739,CLE,37,26,11,384.0,6,3,3,0.5,34,0.176,0,0.176,10.7,35,7,27,0.2,64,0.547,4,0.583,8.8,41,10,30,0.244,98,0.418,4,0.436,9.1
243,1626175,Jordan Mickey,1610612738,BOS,25,9,16,141.0,13,8,5,0.615,35,0.371,1,0.382,5.8,21,9,12,0.429,49,0.429,5,0.477,3.5,34,17,17,0.5,84,0.405,6,0.436,4.4
244,101181,Jose Calderon,1610612737,ATL,41,15,26,539.0,15,4,11,0.267,39,0.385,0,0.385,16.4,59,11,47,0.186,113,0.522,6,0.551,8.8,74,15,58,0.203,152,0.487,6,0.507,10.4
245,203962,Josh Huestis,1610612760,OKC,2,0,2,31.0,4,1,3,0.25,7,0.571,0,0.571,16.8,5,0,5,0.0,8,0.625,1,0.714,5.6,9,1,8,0.111,15,0.6,1,0.643,10.6
246,201177,Josh McRoberts,1610612748,MIA,22,6,16,381.0,23,14,9,0.609,56,0.411,1,0.418,6.8,51,18,33,0.353,99,0.515,8,0.56,5.8,74,32,42,0.432,155,0.477,9,0.507,6.2
247,1626196,Josh Richardson,1610612748,MIA,53,23,30,1614.0,35,11,23,0.314,109,0.321,6,0.34,12.4,133,27,105,0.203,311,0.428,33,0.478,9.6,168,38,128,0.226,420,0.4,39,0.441,10.2
248,201950,Jrue Holiday,1610612740,NOP,67,32,35,2190.0,46,27,19,0.587,165,0.279,4,0.286,9.1,218,43,174,0.197,425,0.513,38,0.563,8.7,264,70,193,0.265,590,0.447,42,0.482,8.8
249,1627823,Juancho Hernangomez,1610612743,DEN,61,29,32,839.0,43,30,13,0.698,129,0.333,7,0.352,5.5,144,45,95,0.313,230,0.626,18,0.679,5.0,187,75,108,0.401,359,0.521,25,0.56,5.2
250,203944,Julius Randle,1610612747,LAL,74,24,50,2132.0,150,100,43,0.667,375,0.4,8,0.409,5.9,486,150,333,0.309,740,0.657,71,0.726,5.1,636,250,376,0.393,1114,0.571,79,0.614,5.3
251,1626147,Justin Anderson,1610612755,PHI,74,23,51,1225.0,69,33,37,0.478,144,0.479,4,0.493,10.2,175,36,139,0.206,300,0.583,22,0.629,5.0,244,69,176,0.283,444,0.55,26,0.584,6.5
252,203120,Justin Hamilton,1610612751,BKN,63,14,49,1153.0,69,47,20,0.681,158,0.437,2,0.442,6.3,182,67,114,0.368,359,0.507,35,0.562,5.0,251,114,134,0.454,516,0.486,37,0.524,5.3
253,202712,Justin Harper,1610612755,PHI,3,1,2,31.0,2,0,2,0.0,6,0.333,0,0.333,12.3,3,2,1,0.667,6,0.5,1,0.6,4.4,5,2,3,0.4,12,0.417,1,0.455,7.5
254,203200,Justin Holiday,1610612752,NYK,82,31,51,1639.0,27,10,17,0.37,101,0.267,6,0.284,13.4,198,41,154,0.207,321,0.617,27,0.673,7.7,225,51,171,0.227,422,0.533,33,0.578,8.4
255,1626159,Justise Winslow,1610612748,MIA,18,4,14,625.0,23,18,6,0.783,86,0.267,2,0.274,7.0,71,18,52,0.254,159,0.447,17,0.5,6.3,94,36,58,0.383,244,0.385,19,0.418,6.5
256,203994,Jusuf Nurkic,1610612757,POR,64,33,31,1383.0,154,116,30,0.753,392,0.393,8,0.401,4.9,311,113,193,0.363,553,0.562,49,0.617,4.1,465,229,223,0.492,941,0.494,57,0.526,4.4
257,203909,KJ McDaniels,1610612751,BKN,49,28,21,505.0,15,11,4,0.733,55,0.273,3,0.288,6.2,67,18,49,0.269,124,0.54,8,0.578,6.6,82,29,53,0.354,178,0.461,11,0.491,6.5
258,1626157,Karl-Anthony Towns,1610612750,MIN,82,31,51,3030.0,296,222,69,0.75,660,0.448,16,0.46,6.1,711,265,445,0.373,1045,0.68,63,0.724,4.4,1007,487,514,0.484,1704,0.591,79,0.62,4.9
259,202695,Kawhi Leonard,1610612759,SAS,73,54,19,2442.0,79,41,38,0.519,212,0.373,8,0.387,9.3,347,102,246,0.294,570,0.609,34,0.647,7.0,426,143,284,0.336,781,0.545,42,0.576,7.5
260,1627770,Kay Felder,1610612739,CLE,42,25,17,386.0,3,3,0,1.0,29,0.103,2,0.111,4.0,38,8,30,0.211,69,0.551,7,0.613,8.7,41,11,30,0.268,98,0.418,9,0.461,8.3
261,203482,Kelly Olynyk,1610612738,BOS,75,49,26,1538.0,73,49,23,0.671,223,0.327,3,0.332,7.1,288,67,221,0.233,492,0.585,44,0.643,5.2,361,116,244,0.321,715,0.505,47,0.54,5.6
262,1626162,Kelly Oubre Jr.,1610612764,WAS,79,47,32,1605.0,61,38,24,0.623,195,0.313,4,0.319,8.2,200,46,153,0.23,334,0.599,30,0.658,6.2,261,84,177,0.322,528,0.494,34,0.528,6.7
263,202689,Kemba Walker,1610612766,CHA,79,36,43,2739.0,45,19,26,0.422,247,0.182,14,0.193,11.6,263,33,229,0.125,541,0.486,59,0.546,8.3,308,52,255,0.169,788,0.391,73,0.431,8.8
264,202702,Kenneth Faried,1610612743,DEN,60,28,32,1280.0,179,141,33,0.788,371,0.482,5,0.489,5.3,274,99,175,0.361,424,0.646,31,0.697,4.9,453,240,208,0.53,793,0.571,36,0.598,5.1
265,203145,Kent Bazemore,1610612737,ATL,73,39,34,1963.0,45,17,26,0.378,153,0.294,1,0.296,11.0,186,31,152,0.167,432,0.431,44,0.479,7.0,231,48,178,0.208,584,0.396,45,0.429,7.8
266,203484,Kentavious Caldwell-Pope,1610612765,DET,76,33,43,2528.0,55,30,24,0.545,153,0.359,3,0.367,10.7,193,25,170,0.13,320,0.603,23,0.65,8.9,248,55,194,0.222,473,0.524,26,0.555,9.4
267,201142,Kevin Durant,1610612744,GSW,62,51,11,2070.0,39,20,22,0.513,142,0.275,4,0.283,8.5,474,123,346,0.259,662,0.716,33,0.754,6.3,513,143,368,0.279,802,0.64,37,0.671,6.5
268,201567,Kevin Love,1610612739,CLE,60,40,20,1885.0,148,97,49,0.655,328,0.451,11,0.467,6.6,518,160,354,0.309,758,0.683,48,0.73,4.4,666,257,403,0.386,1083,0.615,59,0.65,4.9
269,202338,Kevin Seraphin,1610612754,IND,48,23,25,539.0,40,20,18,0.5,107,0.374,4,0.388,7.2,97,19,78,0.196,155,0.626,13,0.683,4.8,137,39,96,0.285,261,0.525,17,0.561,5.5
270,1626172,Kevon Looney,1610612744,GSW,53,44,9,447.0,44,24,20,0.545,110,0.4,5,0.419,6.3,80,30,51,0.375,143,0.559,10,0.602,6.0,124,54,71,0.435,253,0.49,15,0.521,6.1
271,203114,Khris Middleton,1610612749,MIL,29,19,10,889.0,11,3,8,0.273,46,0.239,2,0.25,12.8,112,23,90,0.205,189,0.593,16,0.647,7.1,123,26,98,0.211,235,0.523,18,0.567,7.6
272,202691,Klay Thompson,1610612744,GSW,78,66,12,2649.0,49,20,27,0.408,186,0.263,6,0.272,13.9,236,54,185,0.229,477,0.495,37,0.536,8.0,285,74,212,0.26,662,0.431,43,0.46,8.9
273,201585,Kosta Koufos,1610612758,SAC,71,27,44,1419.0,118,75,38,0.636,264,0.447,4,0.454,6.1,285,86,196,0.302,472,0.604,36,0.654,4.4,403,161,234,0.4,732,0.551,40,0.582,4.9
274,1627739,Kris Dunn,1610612750,MIN,78,30,48,1333.0,24,12,12,0.5,102,0.235,5,0.247,9.8,142,34,108,0.239,301,0.472,35,0.534,6.8,166,46,120,0.277,403,0.412,40,0.457,7.2
275,2743,Kris Humphries,1610612737,ATL,56,31,25,689.0,60,37,22,0.617,149,0.403,2,0.408,6.4,146,52,94,0.356,279,0.523,25,0.575,4.2,206,89,116,0.432,426,0.484,27,0.516,4.8
276,204001,Kristaps Porzingis,1610612752,NYK,66,26,40,2164.0,111,72,37,0.649,242,0.459,6,0.47,8.6,364,139,223,0.382,652,0.558,53,0.608,5.2,475,211,260,0.444,894,0.531,59,0.569,6.0
277,203937,Kyle Anderson,1610612759,SAS,71,53,18,1011.0,33,23,12,0.697,103,0.32,1,0.324,6.7,175,43,130,0.246,267,0.655,16,0.697,6.3,208,66,142,0.317,368,0.565,17,0.593,6.4
278,2594,Kyle Korver,1610612739,CLE,67,33,34,1753.0,7,1,7,0.143,81,0.086,3,0.09,21.3,179,39,138,0.218,370,0.484,36,0.536,7.4,186,40,145,0.215,451,0.412,39,0.451,8.0
279,200768,Kyle Lowry,1610612761,TOR,59,35,24,2210.0,47,22,25,0.468,227,0.207,4,0.211,10.6,235,46,191,0.196,522,0.45,47,0.495,8.4,282,68,216,0.241,749,0.377,51,0.404,8.8
280,203124,Kyle O'Quinn,1610612752,NYK,79,29,50,1229.0,157,111,42,0.707,331,0.474,7,0.485,5.7,282,105,174,0.372,480,0.588,38,0.638,4.3,439,216,216,0.492,810,0.542,45,0.574,4.8
281,202713,Kyle Singler,1610612760,OKC,32,15,17,385.0,8,4,4,0.5,28,0.286,3,0.32,10.7,40,12,28,0.3,79,0.506,4,0.533,7.5,48,16,32,0.333,107,0.449,7,0.48,8.0
282,1627787,Kyle Wiltjer,1610612745,HOU,14,12,2,44.0,4,1,3,0.25,6,0.667,0,0.667,7.4,6,2,4,0.333,11,0.545,2,0.667,7.5,10,3,7,0.3,17,0.588,2,0.667,7.5
283,202681,Kyrie Irving,1610612739,CLE,72,47,25,2525.0,52,24,27,0.462,230,0.226,13,0.24,10.8,178,25,157,0.14,388,0.459,31,0.499,9.3,230,49,184,0.213,616,0.373,44,0.402,9.6
284,200746,LaMarcus Aldridge,1610612759,SAS,71,52,19,2301.0,170,116,50,0.682,360,0.472,10,0.486,5.7,349,106,239,0.304,586,0.596,34,0.632,6.0,519,222,289,0.428,945,0.549,44,0.576,5.9
285,203934,Lamar Patterson,1610612737,ATL,5,1,4,40.0,1,1,0,1.0,3,0.333,0,0.333,14.7,6,1,5,0.167,10,0.6,0,0.6,7.7,7,2,5,0.286,13,0.538,0,0.538,8.7
286,202362,Lance Stephenson,1610612754,IND,18,8,10,362.0,4,1,3,0.25,31,0.129,4,0.148,8.5,48,6,43,0.125,74,0.649,3,0.676,6.7,52,7,46,0.135,103,0.505,7,0.542,6.8
287,202498,Lance Thomas,1610612752,NYK,46,15,31,968.0,32,13,16,0.406,105,0.305,2,0.311,9.1,110,26,83,0.236,217,0.507,13,0.539,7.0,142,39,99,0.275,321,0.442,15,0.464,7.5
288,204038,Langston Galloway,1610612758,SAC,74,29,45,1494.0,27,7,19,0.259,77,0.351,3,0.365,10.3,129,15,114,0.116,243,0.531,26,0.594,9.0,156,22,133,0.141,320,0.488,29,0.536,9.2
289,1626204,Larry Nance Jr.,1610612747,LAL,63,21,42,1442.0,120,71,47,0.592,273,0.44,11,0.458,6.7,249,77,170,0.309,422,0.59,34,0.642,5.1,369,148,217,0.401,694,0.532,45,0.569,5.6
290,202336,Larry Sanders,1610612739,CLE,5,2,3,13.0,3,2,0,0.667,5,0.6,0,0.6,6.2,1,1,0,1.0,1,1.0,0,1.0,1.5,4,3,0,0.75,6,0.667,0,0.667,4.6
291,202730,Lavoy Allen,1610612754,IND,60,31,29,868.0,105,80,24,0.762,227,0.463,12,0.488,5.0,114,32,82,0.281,216,0.528,14,0.564,5.3,219,112,106,0.511,443,0.494,26,0.525,5.2
292,2544,LeBron James,1610612739,CLE,74,51,23,2795.0,97,52,38,0.536,279,0.348,11,0.362,9.2,542,129,414,0.238,783,0.692,45,0.734,6.2,639,181,452,0.283,1061,0.602,56,0.636,6.7
293,2571,Leandro Barbosa,1610612756,PHX,65,19,46,940.0,15,5,10,0.333,75,0.2,4,0.211,13.8,86,8,78,0.093,154,0.558,16,0.623,8.0,101,13,88,0.129,229,0.441,20,0.483,8.9
294,101150,Lou Williams,1610612745,HOU,81,34,47,1993.0,26,11,15,0.423,158,0.165,6,0.171,14.0,176,28,147,0.159,330,0.533,23,0.573,9.4,202,39,162,0.193,488,0.414,29,0.44,10.0
295,201601,Luc Mbah a Moute,1610612746,LAC,80,49,31,1787.0,44,22,22,0.5,131,0.336,5,0.349,10.6,126,38,87,0.302,304,0.414,34,0.467,8.2,170,60,109,0.353,435,0.391,39,0.429,8.8
296,203512,Lucas Nogueira,1610612761,TOR,56,33,23,1067.0,79,50,28,0.633,158,0.5,7,0.523,6.9,159,54,101,0.34,310,0.513,28,0.564,4.6,238,104,129,0.437,468,0.509,35,0.55,5.4
297,2449,Luis Scola,1610612751,BKN,35,7,28,443.0,47,29,16,0.617,88,0.534,3,0.553,5.5,87,26,62,0.299,165,0.527,21,0.604,5.0,134,55,78,0.41,252,0.532,24,0.588,5.1
298,202337,Luke Babbitt,1610612748,MIA,68,35,33,1065.0,12,1,11,0.083,45,0.267,6,0.308,20.0,129,27,103,0.209,311,0.415,30,0.459,6.3,141,28,114,0.199,355,0.397,36,0.442,7.4
299,2736,Luol Deng,1610612747,LAL,56,18,38,1486.0,63,41,22,0.651,174,0.362,11,0.387,8.4,232,56,175,0.241,397,0.584,32,0.636,6.1,295,97,197,0.329,568,0.519,43,0.562,6.5
300,1627781,Malachi Richardson,1610612758,SAC,22,9,13,198.0,3,0,3,0.0,8,0.375,0,0.375,19.5,20,2,18,0.1,38,0.526,3,0.571,6.8,23,2,21,0.087,46,0.5,3,0.535,8.5
301,1627763,Malcolm Brogdon,1610612749,MIL,75,38,37,1982.0,47,20,28,0.426,141,0.333,5,0.346,12.0,166,45,122,0.271,381,0.436,27,0.469,8.4,213,65,150,0.305,522,0.408,32,0.435,9.2
302,1627098,Malcolm Delaney,1610612737,ATL,73,37,36,1248.0,10,4,5,0.4,57,0.175,3,0.185,17.4,113,14,98,0.124,246,0.459,25,0.511,8.2,123,18,103,0.146,303,0.406,28,0.447,8.9
303,1627736,Malik Beasley,1610612743,DEN,21,11,10,162.0,4,2,2,0.5,16,0.25,0,0.25,4.3,12,3,9,0.25,30,0.4,4,0.462,5.0,16,5,11,0.313,46,0.348,4,0.381,4.8
304,202412,Manny Harris,1610612742,DAL,4,1,3,25.0,3,3,0,1.0,9,0.333,1,0.375,5.1,6,0,6,0.0,10,0.6,0,0.6,4.5,9,3,6,0.333,19,0.474,1,0.5,4.7
305,1938,Manu Ginobili,1610612759,SAS,68,51,17,1266.0,28,16,12,0.571,109,0.257,8,0.277,11.6,127,21,104,0.165,245,0.518,15,0.552,8.0,155,37,116,0.239,354,0.438,23,0.468,8.6
306,201188,Marc Gasol,1610612763,MEM,74,40,34,2531.0,60,32,26,0.533,170,0.353,10,0.375,10.3,404,160,239,0.396,703,0.575,74,0.642,5.0,464,192,265,0.414,871,0.533,84,0.59,5.7
307,1626273,Marcelo Huertas,1610612747,LAL,23,5,18,237.0,2,0,2,0.0,13,0.154,0,0.154,14.5,22,3,19,0.136,39,0.564,1,0.579,8.8,24,3,21,0.125,51,0.471,1,0.48,9.3
308,101162,Marcin Gortat,1610612764,WAS,82,49,33,2556.0,238,153,83,0.643,589,0.404,16,0.415,6.3,611,181,428,0.296,992,0.616,84,0.673,4.4,849,334,511,0.393,1576,0.539,100,0.575,5.0
309,201158,Marco Belinelli,1610612766,CHA,74,34,40,1778.0,14,6,9,0.429,84,0.167,2,0.171,12.3,164,15,147,0.091,285,0.575,24,0.628,8.3,178,21,156,0.118,369,0.482,26,0.519,8.6
310,1627875,Marcus Georges-Hunt,1610612753,ORL,5,2,3,48.0,1,1,0,1.0,2,0.5,0,0.5,5.9,8,1,7,0.125,12,0.667,1,0.727,5.9,9,2,7,0.222,14,0.643,1,0.692,5.9
311,202694,Marcus Morris,1610612765,DET,79,36,43,2565.0,77,41,29,0.532,244,0.316,5,0.322,8.9,289,72,214,0.249,526,0.549,38,0.592,6.6,366,113,243,0.309,768,0.477,43,0.505,7.1
312,203935,Marcus Smart,1610612738,BOS,79,51,28,2399.0,78,49,30,0.628,271,0.288,5,0.293,7.2,227,78,146,0.344,409,0.555,27,0.594,7.9,305,127,176,0.416,680,0.449,32,0.471,7.7
313,201977,Marcus Thornton,1610612764,WAS,33,15,18,575.0,22,11,8,0.5,63,0.349,1,0.355,5.7,54,10,43,0.185,96,0.563,6,0.6,7.8,76,21,51,0.276,159,0.478,7,0.5,7.3
314,1626209,Mario Hezonja,1610612753,ORL,65,20,45,960.0,20,8,12,0.4,86,0.233,4,0.244,12.0,126,36,92,0.286,214,0.589,19,0.646,5.4,146,44,104,0.301,299,0.488,23,0.529,6.3
315,202693,Markieff Morris,1610612764,WAS,76,45,31,2374.0,107,72,33,0.673,263,0.407,9,0.421,5.5,386,119,261,0.308,606,0.637,54,0.699,5.4,493,191,294,0.387,869,0.567,63,0.612,5.4
316,1627737,Marquese Chriss,1610612756,PHX,80,23,57,1705.0,94,61,30,0.649,275,0.342,6,0.349,5.6,246,69,175,0.28,408,0.603,36,0.661,5.4,340,130,205,0.382,681,0.499,42,0.532,5.5
317,201578,Marreese Speights,1610612746,LAC,82,51,31,1286.0,88,73,14,0.83,223,0.395,4,0.402,4.8,285,104,179,0.365,479,0.595,38,0.646,4.0,373,177,193,0.475,702,0.531,42,0.565,4.2
318,1627850,Marshall Plumlee,1610612752,NYK,21,6,15,170.0,23,11,11,0.478,56,0.411,0,0.411,5.1,28,7,21,0.25,54,0.519,6,0.583,6.4,51,18,32,0.353,110,0.464,6,0.49,5.8
319,101107,Marvin Williams,1610612766,CHA,76,32,44,2295.0,89,52,36,0.584,221,0.403,8,0.418,8.4,411,96,312,0.234,674,0.61,63,0.673,5.8,500,148,348,0.296,894,0.559,71,0.608,6.3
320,203486,Mason Plumlee,1610612743,DEN,81,38,43,2148.0,170,102,69,0.6,460,0.37,12,0.379,5.7,435,142,292,0.326,778,0.559,74,0.618,4.6,605,244,361,0.403,1236,0.489,86,0.526,4.9
321,2440,Matt Barnes,1610612744,GSW,74,38,36,1776.0,70,40,29,0.571,204,0.343,6,0.354,7.9,314,86,227,0.274,502,0.625,31,0.667,5.4,384,126,256,0.328,703,0.546,37,0.577,5.9
322,203521,Matthew Dellavedova,1610612749,MIL,76,39,37,1986.0,24,11,13,0.458,128,0.188,5,0.195,11.9,123,22,101,0.179,306,0.402,22,0.433,11.4,147,33,114,0.224,434,0.339,27,0.361,11.5
323,203090,Maurice Harkless,1610612757,POR,77,38,39,2223.0,125,79,39,0.632,341,0.367,14,0.382,6.4,216,68,143,0.315,422,0.512,33,0.555,7.3,341,147,182,0.431,762,0.448,47,0.477,7.0
324,1626254,Maurice Ndour,1610612752,NYK,32,10,22,331.0,22,13,10,0.591,56,0.393,2,0.407,7.3,42,10,30,0.238,88,0.477,6,0.512,6.1,64,23,40,0.359,144,0.444,8,0.471,6.6
325,1897,Metta World Peace,1610612747,LAL,25,8,17,160.0,5,1,3,0.2,19,0.263,0,0.263,14.3,15,2,13,0.133,26,0.577,2,0.625,7.8,20,3,16,0.15,45,0.444,2,0.465,9.1
326,203086,Meyers Leonard,1610612757,POR,74,37,37,1222.0,27,14,12,0.519,97,0.278,2,0.284,8.3,210,68,141,0.324,391,0.537,32,0.585,4.7,237,82,153,0.346,488,0.486,34,0.522,5.1
327,201563,Michael Beasley,1610612749,MIL,56,23,33,934.0,40,27,12,0.675,104,0.385,2,0.392,5.9,153,59,93,0.386,244,0.627,16,0.671,4.9,193,86,105,0.446,348,0.555,18,0.585,5.1
328,203487,Michael Carter-Williams,1610612741,CHI,45,25,20,846.0,24,11,12,0.458,91,0.264,4,0.276,12.0,129,27,102,0.209,224,0.576,11,0.606,6.6,153,38,114,0.248,315,0.486,15,0.51,7.5
329,1627771,Michael Gbinije,1610612765,DET,9,7,2,32.0,2,1,0,0.5,5,0.4,0,0.4,4.3,1,0,1,0.0,2,0.5,0,0.5,6.0,3,1,1,0.333,7,0.429,0,0.429,5.2
330,203077,Michael Kidd-Gilchrist,1610612766,CHA,81,36,45,2349.0,156,97,57,0.622,358,0.436,14,0.453,7.4,409,116,288,0.284,699,0.585,60,0.64,5.6,565,213,345,0.377,1055,0.536,74,0.576,6.1
331,201144,Mike Conley,1610612763,MEM,69,35,34,2292.0,31,10,23,0.323,132,0.235,3,0.24,15.8,210,28,183,0.133,405,0.519,28,0.557,9.6,241,38,206,0.158,537,0.449,31,0.476,10.6
332,2399,Mike Dunleavy,1610612737,ATL,53,34,19,841.0,18,7,11,0.389,70,0.257,1,0.261,11.8,97,22,76,0.227,214,0.453,13,0.483,6.9,115,29,87,0.252,284,0.405,14,0.426,7.6
333,2034,Mike Miller,1610612743,DEN,19,8,11,148.0,2,0,2,0.0,8,0.25,0,0.25,24.5,35,5,30,0.143,52,0.673,2,0.7,5.0,37,5,32,0.135,60,0.617,2,0.638,6.0
334,203488,Mike Muscala,1610612737,ATL,70,36,34,1237.0,76,51,23,0.671,206,0.369,2,0.373,8.1,164,66,97,0.402,370,0.443,40,0.497,5.5,240,117,120,0.488,575,0.417,42,0.45,6.3
335,203118,Mike Scott,1610612737,ATL,18,7,11,195.0,10,3,7,0.3,31,0.323,1,0.333,8.2,27,6,20,0.222,52,0.519,3,0.551,6.9,37,9,27,0.243,83,0.446,4,0.468,7.3
336,1627861,Mike Tobey,1610612766,CHA,2,0,2,25.0,2,2,0,1.0,4,0.5,0,0.5,2.8,1,0,1,0.0,4,0.25,1,0.333,8.5,3,2,1,0.667,8,0.375,1,0.429,4.7
337,203101,Miles Plumlee,1610612766,CHA,45,19,26,485.0,38,20,15,0.526,108,0.352,1,0.355,7.6,57,26,31,0.456,153,0.373,20,0.429,4.2,95,46,46,0.484,260,0.365,21,0.397,5.5
338,1627851,Mindaugas Kuzminskas,1610612752,NYK,68,24,44,1016.0,47,32,17,0.681,144,0.326,2,0.331,5.5,79,19,61,0.241,168,0.47,13,0.51,8.3,126,51,78,0.405,312,0.404,15,0.424,7.3
339,203141,Mirza Teletovic,1610612749,MIL,70,36,34,1133.0,11,8,4,0.727,46,0.239,1,0.244,11.5,151,46,104,0.305,287,0.526,17,0.559,5.6,162,54,108,0.333,333,0.486,18,0.514,6.0
340,101145,Monta Ellis,1610612754,IND,73,39,34,1971.0,18,5,13,0.278,132,0.136,4,0.141,14.4,184,31,151,0.168,312,0.59,13,0.615,9.1,202,36,164,0.178,443,0.456,17,0.474,9.6
341,1626149,Montrezl Harrell,1610612745,HOU,58,39,19,1064.0,81,48,30,0.593,193,0.42,4,0.429,6.0,138,48,86,0.348,277,0.498,24,0.545,5.8,219,96,116,0.438,470,0.466,28,0.495,5.8
342,1626167,Myles Turner,1610612754,IND,80,42,38,2520.0,137,88,44,0.642,317,0.432,9,0.445,6.2,446,194,255,0.435,917,0.486,108,0.551,4.3,583,282,299,0.484,1233,0.473,117,0.522,4.7
343,202357,Nemanja Bjelica,1610612750,MIN,65,28,37,1190.0,57,38,18,0.667,139,0.41,6,0.429,7.7,187,66,120,0.353,322,0.581,18,0.615,5.7,244,104,138,0.426,461,0.529,24,0.558,6.1
344,2403,Nene,1610612745,HOU,67,47,20,1198.0,95,59,34,0.621,248,0.383,5,0.391,7.2,187,81,105,0.433,380,0.492,37,0.545,4.9,282,140,139,0.496,627,0.45,42,0.482,5.6
345,203457,Nerlens Noel,1610612742,DAL,51,24,27,1047.0,93,56,35,0.602,213,0.437,7,0.451,6.3,201,79,121,0.393,353,0.569,42,0.646,4.2,294,135,156,0.459,566,0.519,49,0.569,4.8
346,2555,Nick Collison,1610612760,OKC,20,10,10,128.0,9,5,4,0.556,29,0.31,1,0.321,3.9,22,8,14,0.364,42,0.524,1,0.537,6.2,31,13,18,0.419,71,0.437,2,0.449,5.5
347,201156,Nick Young,1610612747,LAL,60,19,41,1556.0,25,8,17,0.32,87,0.287,7,0.313,15.6,113,22,90,0.195,236,0.479,20,0.523,8.8,138,30,107,0.217,323,0.427,27,0.466,10.0
348,201587,Nicolas Batum,1610612766,CHA,77,35,42,2617.0,46,26,17,0.565,248,0.185,9,0.192,10.0,435,98,337,0.225,632,0.688,37,0.731,5.8,481,124,354,0.258,878,0.548,46,0.578,6.2
349,1627852,Nicolas Brussino,1610612742,DAL,54,18,36,521.0,26,13,14,0.5,54,0.481,0,0.481,12.5,69,15,54,0.217,116,0.595,5,0.622,7.2,95,28,68,0.295,170,0.559,5,0.576,8.7
350,1627879,Nicolas Laprovittola,1610612759,SAS,18,15,3,174.0,1,0,1,0.0,12,0.083,0,0.083,22.2,9,1,7,0.111,26,0.346,3,0.391,9.6,10,1,8,0.1,38,0.263,3,0.286,11.0
351,203917,Nik Stauskas,1610612755,PHI,80,27,53,2188.0,21,5,18,0.238,113,0.186,4,0.193,18.4,205,25,180,0.122,377,0.544,23,0.579,7.9,226,30,198,0.133,489,0.462,27,0.489,8.9
352,203999,Nikola Jokic,1610612743,DEN,72,36,36,2008.0,209,159,44,0.761,424,0.493,7,0.501,5.0,499,178,313,0.357,802,0.622,75,0.686,4.4,708,337,357,0.476,1226,0.577,82,0.619,4.6
353,202703,Nikola Mirotic,1610612741,CHI,70,37,33,1679.0,61,34,27,0.557,159,0.384,3,0.391,7.2,323,100,224,0.31,545,0.593,40,0.64,5.1,384,134,251,0.349,702,0.547,43,0.583,5.5
354,202696,Nikola Vucevic,1610612753,ORL,75,27,48,2163.0,176,128,38,0.727,340,0.518,8,0.53,5.9,603,229,372,0.38,890,0.678,61,0.727,4.3,779,357,410,0.458,1226,0.635,69,0.673,4.7
355,203943,Noah Vonleh,1610612757,POR,74,38,36,1265.0,131,100,29,0.763,325,0.403,8,0.413,5.0,256,98,154,0.383,462,0.554,50,0.621,4.0,387,198,183,0.512,785,0.493,58,0.532,4.3
356,1626181,Norman Powell,1610612761,TOR,75,46,29,1341.0,26,14,12,0.538,116,0.224,5,0.234,13.1,140,26,116,0.186,273,0.513,19,0.551,7.3,166,40,128,0.241,389,0.427,24,0.455,8.2
357,202708,Norris Cole,1610612760,OKC,13,5,8,125.0,0,0,0,0.0,7,0.0,0,0.0,0.0,11,2,8,0.182,24,0.458,3,0.524,10.8,11,2,8,0.182,31,0.355,3,0.393,10.8
358,1627855,Okaro White,1610612748,MIA,35,26,9,471.0,25,15,10,0.6,63,0.397,2,0.41,7.7,57,18,39,0.316,125,0.456,17,0.528,5.2,82,33,49,0.402,188,0.436,19,0.485,6.0
359,201600,Omer Asik,1610612740,NOP,31,12,19,482.0,48,33,13,0.688,88,0.545,1,0.552,3.9,115,39,74,0.339,207,0.556,18,0.608,4.0,163,72,87,0.442,295,0.553,19,0.591,3.9
360,201956,Omri Casspi,1610612750,MIN,36,12,24,642.0,27,16,11,0.593,96,0.281,2,0.287,6.6,85,15,70,0.176,171,0.497,23,0.574,5.4,112,31,81,0.277,266,0.421,25,0.465,5.7
361,203490,Otto Porter Jr.,1610612764,WAS,80,48,32,2605.0,118,61,52,0.517,341,0.346,8,0.354,8.6,396,83,308,0.21,673,0.588,52,0.638,5.7,514,144,360,0.28,1013,0.507,60,0.539,6.4
362,200782,PJ Tucker,1610612761,TOR,79,34,45,2180.0,115,72,42,0.626,346,0.332,16,0.348,7.8,343,83,260,0.242,555,0.618,55,0.686,6.0,458,155,302,0.338,899,0.509,71,0.553,6.4
363,1627783,Pascal Siakam,1610612761,TOR,54,34,20,832.0,64,40,22,0.625,139,0.46,5,0.478,7.1,118,38,80,0.322,223,0.529,23,0.59,5.4,182,78,102,0.429,362,0.503,28,0.545,6.0
364,1626192,Pat Connaughton,1610612757,POR,39,18,21,316.0,10,5,5,0.5,18,0.556,0,0.556,11.6,42,9,33,0.214,71,0.592,8,0.667,5.6,52,14,38,0.269,89,0.584,8,0.642,6.8
365,1627868,Patricio Garino,1610612753,ORL,5,2,3,43.0,1,1,0,1.0,2,0.5,0,0.5,3.1,6,0,6,0.0,12,0.5,1,0.545,7.9,7,1,6,0.143,14,0.5,1,0.538,7.2
366,201976,Patrick Beverley,1610612745,HOU,67,46,21,2058.0,95,44,49,0.463,271,0.351,6,0.358,10.3,298,57,242,0.191,561,0.531,55,0.589,7.4,393,101,291,0.257,832,0.472,61,0.51,8.1
367,1627775,Patrick McCaw,1610612744,GSW,71,57,14,1074.0,21,5,15,0.238,72,0.292,4,0.309,11.9,79,20,58,0.253,153,0.516,15,0.572,8.9,100,25,73,0.25,225,0.444,19,0.485,9.5
368,202335,Patrick Patterson,1610612761,TOR,65,42,23,1599.0,62,37,23,0.597,141,0.44,5,0.456,8.9,231,67,165,0.29,403,0.573,27,0.614,6.0,293,104,188,0.355,542,0.541,32,0.575,6.6
369,201988,Patty Mills,1610612759,SAS,80,60,20,1754.0,24,7,18,0.292,114,0.211,7,0.224,18.0,117,6,111,0.051,226,0.518,14,0.552,12.0,141,13,129,0.092,340,0.415,21,0.442,13.3
370,2200,Pau Gasol,1610612759,SAS,63,47,16,1599.0,107,74,31,0.692,255,0.42,7,0.431,6.7,384,132,254,0.344,583,0.659,39,0.706,4.4,491,206,285,0.42,836,0.587,46,0.622,4.9
371,202331,Paul George,1610612754,IND,74,39,35,2658.0,58,30,27,0.517,206,0.282,7,0.291,9.7,430,91,339,0.212,707,0.608,55,0.66,6.0,488,121,366,0.248,912,0.535,62,0.574,6.4
372,200794,Paul Millsap,1610612737,ATL,69,40,29,2343.0,111,70,33,0.631,303,0.366,7,0.375,7.8,422,142,280,0.336,784,0.538,61,0.584,5.0,533,212,313,0.398,1086,0.491,68,0.524,5.5
373,1718,Paul Pierce,1610612746,LAC,25,16,9,277.0,1,1,0,1.0,10,0.1,1,0.111,2.6,47,15,31,0.319,71,0.662,8,0.746,5.7,48,16,31,0.333,81,0.593,9,0.667,5.6
374,1627835,Paul Zipser,1610612741,CHI,44,21,23,843.0,15,5,10,0.333,66,0.227,2,0.234,13.9,110,19,88,0.173,200,0.55,23,0.621,6.0,125,24,98,0.192,266,0.47,25,0.519,7.0
375,203510,Pierre Jackson,1610612742,DAL,9,4,5,84.0,1,0,1,0.0,9,0.111,0,0.111,26.7,8,1,7,0.125,17,0.471,2,0.533,10.8,9,1,8,0.111,26,0.346,2,0.375,12.6
376,203112,Quincy Acy,1610612751,BKN,38,11,27,558.0,20,15,5,0.75,71,0.282,2,0.29,5.7,95,23,71,0.242,164,0.579,16,0.642,4.1,115,38,76,0.33,235,0.489,18,0.53,4.4
377,1626188,Quinn Cook,1610612740,NOP,14,9,5,187.0,1,0,1,0.0,6,0.167,0,0.167,69.0,6,0,6,0.0,20,0.3,2,0.333,8.2,7,0,7,0.0,26,0.269,2,0.292,16.9
378,1626154,RJ Hunter,1610612741,CHI,3,2,1,9.0,0,0,0,0.0,0,0.0,0,0.0,0.0,1,0,1,0.0,1,1.0,0,1.0,12.7,1,0,1,0.0,1,1.0,0,1.0,12.7
379,200765,Rajon Rondo,1610612741,CHI,69,34,35,1843.0,73,23,49,0.315,233,0.313,5,0.32,11.8,282,27,257,0.096,454,0.621,23,0.654,7.5,355,50,306,0.141,685,0.518,28,0.54,8.4
380,1626176,Rakeem Christmas,1610612754,IND,29,14,15,219.0,26,14,11,0.538,65,0.4,1,0.406,6.4,30,8,22,0.267,58,0.517,3,0.545,5.9,56,22,33,0.393,123,0.455,4,0.471,6.1
381,201196,Ramon Sessions,1610612766,CHA,50,23,27,811.0,11,6,5,0.545,58,0.19,6,0.212,15.3,62,9,55,0.145,100,0.62,8,0.674,10.5,73,15,60,0.205,158,0.462,14,0.507,11.2
382,200751,Randy Foye,1610612751,BKN,68,17,51,1277.0,9,4,6,0.444,85,0.106,1,0.107,16.9,145,16,130,0.11,288,0.503,25,0.551,8.5,154,20,136,0.13,373,0.413,26,0.444,9.1
383,1626173,Rashad Vaughn,1610612749,MIL,41,18,23,459.0,4,1,3,0.25,22,0.182,1,0.19,20.2,45,7,38,0.156,86,0.523,9,0.584,6.6,49,8,41,0.163,108,0.454,10,0.5,7.7
384,203526,Raul Neto,1610612762,UTA,40,24,16,346.0,4,1,3,0.25,20,0.2,1,0.211,23.9,26,2,25,0.077,64,0.406,8,0.464,10.3,30,3,28,0.1,84,0.357,9,0.4,12.1
385,101109,Raymond Felton,1610612746,LAC,80,50,30,1700.0,33,15,16,0.455,131,0.252,7,0.266,11.6,185,41,145,0.222,325,0.569,20,0.607,9.2,218,56,161,0.257,456,0.478,27,0.508,9.6
386,203493,Reggie Bullock,1610612765,DET,31,13,18,467.0,13,6,7,0.462,39,0.333,2,0.351,15.5,51,11,39,0.216,77,0.662,8,0.739,6.0,64,17,46,0.266,115,0.557,10,0.61,8.0
387,202704,Reggie Jackson,1610612765,DET,52,23,29,1424.0,21,11,10,0.524,101,0.208,7,0.223,11.6,93,16,77,0.172,216,0.431,35,0.514,8.5,114,27,87,0.237,317,0.36,42,0.415,9.1
388,202130,Reggie Williams,1610612740,NOP,6,1,5,79.0,2,1,1,0.5,5,0.4,0,0.4,14.4,4,1,3,0.25,10,0.4,1,0.444,5.7,6,2,4,0.333,15,0.4,1,0.429,8.6
389,2210,Richard Jefferson,1610612739,CLE,79,50,29,1614.0,28,13,14,0.464,147,0.19,3,0.194,11.4,175,39,133,0.223,387,0.452,34,0.496,7.1,203,52,147,0.256,533,0.381,37,0.409,7.7
390,1626158,Richaun Holmes,1610612755,PHI,57,16,41,1193.0,94,65,28,0.691,247,0.381,12,0.4,5.6,217,88,129,0.406,384,0.565,34,0.62,4.4,311,153,157,0.492,630,0.494,46,0.533,4.8
391,201937,Ricky Rubio,1610612750,MIN,75,28,47,2469.0,68,20,48,0.294,208,0.327,12,0.347,14.3,237,35,202,0.148,428,0.554,32,0.598,9.6,305,55,250,0.18,636,0.48,44,0.515,10.6
392,203496,Robert Covington,1610612755,PHI,67,27,40,2119.0,92,48,42,0.522,238,0.387,12,0.407,9.5,344,108,237,0.314,630,0.546,64,0.608,5.3,436,156,279,0.358,868,0.502,76,0.551,6.1
393,201577,Robin Lopez,1610612741,CHI,81,40,41,2271.0,244,192,46,0.787,595,0.41,17,0.422,4.2,276,127,148,0.46,622,0.444,62,0.493,5.3,520,319,194,0.613,1216,0.428,79,0.457,4.8
394,203918,Rodney Hood,1610612762,UTA,59,40,19,1593.0,16,7,10,0.438,64,0.25,3,0.262,13.5,186,39,146,0.21,320,0.581,24,0.628,7.5,202,46,156,0.228,382,0.529,27,0.569,8.0
395,203585,Rodney McGruder,1610612748,MIA,78,40,38,1966.0,94,42,53,0.447,254,0.37,11,0.387,9.5,162,35,126,0.216,350,0.463,37,0.518,8.6,256,77,179,0.301,604,0.424,48,0.46,8.9
396,201155,Rodney Stuckey,1610612754,IND,39,17,22,696.0,6,2,3,0.333,44,0.136,1,0.14,11.2,78,14,64,0.179,136,0.574,9,0.614,9.0,84,16,67,0.19,180,0.467,10,0.494,9.2
397,1627758,Ron Baker,1610612752,NYK,52,14,38,857.0,12,5,7,0.417,47,0.255,0,0.255,7.5,86,20,68,0.233,164,0.524,9,0.555,9.0,98,25,75,0.255,211,0.464,9,0.485,8.8
398,1626178,Rondae Hollis-Jefferson,1610612751,BKN,77,19,58,1741.0,95,59,35,0.621,280,0.339,7,0.348,7.3,351,98,252,0.279,620,0.566,50,0.616,5.3,446,157,287,0.352,900,0.496,57,0.529,5.8
399,101179,Ronnie Price,1610612756,PHX,14,4,10,134.0,3,0,3,0.0,10,0.3,2,0.375,20.9,8,0,8,0.0,20,0.4,2,0.444,11.7,11,0,11,0.0,30,0.367,4,0.423,14.2
400,201579,Roy Hibbert,1610612743,DEN,48,24,24,682.0,54,34,16,0.63,136,0.397,2,0.403,4.0,98,37,60,0.378,219,0.447,30,0.519,5.0,152,71,76,0.467,355,0.428,32,0.471,4.7
401,200752,Rudy Gay,1610612758,SAC,30,11,19,1013.0,35,21,14,0.6,121,0.289,4,0.299,6.9,155,40,115,0.258,234,0.662,16,0.711,6.1,190,61,129,0.321,355,0.535,20,0.567,6.3
402,203497,Rudy Gobert,1610612762,UTA,81,51,30,2744.0,314,236,73,0.752,707,0.444,5,0.447,5.1,721,241,474,0.334,1200,0.601,100,0.655,4.1,1035,477,547,0.461,1904,0.544,105,0.575,4.4
403,201566,Russell Westbrook,1610612760,OKC,81,46,35,2802.0,137,75,61,0.547,490,0.28,13,0.287,8.9,727,117,606,0.161,907,0.802,29,0.828,6.1,864,192,667,0.222,1387,0.623,42,0.642,6.6
404,201583,Ryan Anderson,1610612745,HOU,72,50,22,2116.0,112,78,35,0.696,274,0.409,10,0.424,6.7,218,74,142,0.339,427,0.511,42,0.566,6.3,330,152,177,0.461,701,0.471,52,0.508,6.4
405,203527,Ryan Kelly,1610612737,ATL,16,6,10,110.0,1,0,1,0.0,8,0.125,2,0.167,11.6,17,7,10,0.412,32,0.531,5,0.63,3.9,18,7,11,0.389,40,0.45,7,0.545,4.4
406,1626257,Salah Mejri,1610612742,DAL,72,28,44,889.0,95,55,37,0.579,197,0.482,2,0.487,7.4,206,82,123,0.398,326,0.632,24,0.682,4.7,301,137,160,0.455,523,0.576,26,0.606,5.5
407,1626155,Sam Dekker,1610612745,HOU,77,52,25,1419.0,94,59,34,0.628,205,0.459,7,0.475,7.0,190,47,142,0.247,376,0.505,30,0.549,7.0,284,106,176,0.373,580,0.49,37,0.523,7.0
408,2756,Sasha Vujacic,1610612752,NYK,42,14,28,408.0,12,4,8,0.333,35,0.343,1,0.353,11.8,47,8,39,0.17,91,0.516,14,0.61,9.7,59,12,47,0.203,126,0.468,15,0.532,10.1
409,203930,Sean Kilpatrick,1610612751,BKN,69,14,55,1730.0,22,11,8,0.5,155,0.142,4,0.146,9.3,257,24,231,0.093,421,0.61,39,0.673,6.7,279,35,239,0.125,575,0.485,43,0.524,6.9
410,203902,Semaj Christon,1610612760,OKC,64,36,28,973.0,19,2,17,0.105,89,0.213,5,0.226,15.6,68,12,58,0.176,158,0.43,13,0.469,9.2,87,14,75,0.161,247,0.352,18,0.38,10.5
411,201586,Serge Ibaka,1610612761,TOR,79,37,42,2422.0,129,89,35,0.69,310,0.416,4,0.422,6.1,409,133,275,0.325,709,0.577,68,0.638,4.8,538,222,310,0.413,1018,0.528,72,0.569,5.1
412,200771,Sergio Rodriguez,1610612755,PHI,68,24,44,1517.0,21,5,17,0.238,114,0.184,1,0.186,16.6,136,13,123,0.096,226,0.602,7,0.621,11.4,157,18,140,0.115,339,0.463,8,0.474,12.2
413,203552,Seth Curry,1610612742,DAL,69,29,40,2005.0,25,7,20,0.28,106,0.236,7,0.253,15.8,150,22,129,0.147,300,0.5,25,0.545,9.8,175,29,149,0.166,405,0.432,32,0.469,10.8
414,203498,Shabazz Muhammad,1610612750,MIN,78,29,49,1516.0,84,51,32,0.607,269,0.312,13,0.328,7.4,136,34,102,0.25,215,0.633,11,0.667,6.0,220,85,134,0.386,484,0.455,24,0.478,6.6
415,203894,Shabazz Napier,1610612757,POR,53,26,27,512.0,8,3,5,0.375,32,0.25,0,0.25,13.6,53,8,45,0.151,104,0.51,11,0.57,8.1,61,11,50,0.18,136,0.449,11,0.488,8.9
416,2733,Shaun Livingston,1610612744,GSW,76,63,13,1345.0,28,9,15,0.321,105,0.267,10,0.295,11.0,123,25,99,0.203,248,0.496,14,0.526,9.2,151,34,114,0.225,353,0.428,24,0.459,9.5
417,1627848,Shawn Long,1610612755,PHI,18,5,13,234.0,41,29,11,0.707,79,0.519,3,0.539,5.9,44,17,27,0.386,82,0.537,5,0.571,4.2,85,46,38,0.541,161,0.528,8,0.556,5.0
418,1627815,Sheldon Mac,1610612764,WAS,30,17,13,287.0,4,0,4,0.0,20,0.2,2,0.222,11.2,30,4,26,0.133,56,0.536,5,0.588,8.4,34,4,30,0.118,76,0.447,7,0.493,8.7
419,202714,Shelvin Mack,1610612762,UTA,55,34,21,1205.0,20,2,19,0.1,89,0.225,3,0.233,17.7,105,17,90,0.162,219,0.479,19,0.525,7.9,125,19,109,0.152,307,0.407,22,0.439,9.6
420,1627746,Skal Labissiere,1610612758,SAC,33,9,24,612.0,51,33,18,0.647,122,0.418,4,0.432,5.8,111,30,82,0.27,193,0.575,20,0.642,5.3,162,63,100,0.389,315,0.514,24,0.557,5.5
421,203524,Solomon Hill,1610612740,NOP,80,34,46,2374.0,51,30,22,0.588,154,0.331,8,0.349,8.4,256,65,191,0.254,480,0.533,40,0.582,7.5,307,95,213,0.309,634,0.484,48,0.524,7.7
422,203915,Spencer Dinwiddie,1610612751,BKN,58,13,45,1312.0,26,11,15,0.423,94,0.277,4,0.289,12.1,134,19,115,0.142,248,0.54,18,0.583,7.7,160,30,130,0.188,342,0.468,22,0.5,8.4
423,201150,Spencer Hawes,1610612749,MIL,54,27,27,797.0,38,19,18,0.5,98,0.388,1,0.392,5.9,153,47,106,0.307,282,0.543,33,0.614,5.3,191,66,124,0.346,380,0.503,34,0.552,5.4
424,1626169,Stanley Johnson,1610612765,DET,77,35,42,1371.0,36,17,18,0.472,121,0.298,1,0.3,9.0,153,26,127,0.17,279,0.548,24,0.6,6.5,189,43,145,0.228,400,0.473,25,0.504,6.9
425,201939,Stephen Curry,1610612744,GSW,79,65,14,2639.0,61,36,27,0.59,294,0.207,10,0.215,11.1,292,40,253,0.137,591,0.494,42,0.532,9.5,353,76,280,0.215,885,0.399,52,0.424,9.8
426,1627757,Stephen Zimmerman,1610612753,ORL,19,8,11,108.0,11,8,3,0.727,32,0.344,0,0.344,8.9,24,8,16,0.333,35,0.686,1,0.706,5.3,35,16,19,0.457,67,0.522,1,0.53,6.4
427,200779,Steve Novak,1610612749,MIL,8,6,2,22.0,0,0,0,0.0,0,0.0,0,0.0,0.0,3,0,3,0.0,2,1.5,0,1.5,7.0,3,0,3,0.0,2,1.5,0,1.5,7.0
428,203500,Steven Adams,1610612760,OKC,80,47,33,2389.0,281,212,60,0.754,645,0.436,11,0.443,5.3,332,116,215,0.349,619,0.536,56,0.59,5.5,613,328,275,0.535,1263,0.485,67,0.513,5.4
429,204456,T.J. McConnell,1610612755,PHI,81,27,54,2133.0,39,8,36,0.205,200,0.195,7,0.202,15.0,212,23,192,0.108,384,0.552,24,0.589,9.3,251,31,228,0.124,583,0.431,31,0.455,10.2
430,203933,T.J. Warren,1610612756,PHX,64,19,45,1994.0,124,69,53,0.556,279,0.444,5,0.453,9.3,212,66,149,0.311,355,0.597,26,0.644,7.4,336,135,202,0.402,630,0.533,31,0.561,8.1
431,201959,Taj Gibson,1610612760,OKC,78,41,37,1989.0,158,110,42,0.696,435,0.363,9,0.371,6.1,327,103,223,0.315,560,0.584,39,0.628,5.2,485,213,265,0.439,992,0.489,48,0.514,5.5
432,204028,Tarik Black,1610612747,LAL,67,24,43,1091.0,144,104,38,0.722,333,0.432,11,0.447,4.8,199,75,123,0.377,371,0.536,30,0.584,5.0,343,179,161,0.522,702,0.489,41,0.519,4.9
433,1627752,Taurean Prince,1610612737,ATL,59,28,31,981.0,25,14,11,0.56,84,0.298,1,0.301,8.6,132,36,95,0.273,231,0.571,17,0.617,6.2,157,50,106,0.318,315,0.498,18,0.529,6.6
434,203093,Terrence Jones,1610612749,MIL,54,20,34,1271.0,65,41,23,0.631,178,0.365,4,0.374,6.2,241,80,158,0.332,422,0.571,24,0.606,5.1,306,121,181,0.395,599,0.511,28,0.536,5.3
435,203082,Terrence Ross,1610612753,ORL,77,38,39,1932.0,17,7,9,0.412,73,0.233,5,0.25,13.3,185,40,144,0.216,327,0.566,30,0.623,7.1,202,47,153,0.233,398,0.508,35,0.556,7.6
436,1626179,Terry Rozier,1610612738,BOS,74,47,27,1263.0,40,17,23,0.425,126,0.317,6,0.333,10.9,187,34,153,0.182,330,0.567,25,0.613,7.2,227,51,176,0.225,456,0.498,31,0.534,7.8
437,200757,Thabo Sefolosha,1610612737,ATL,62,32,30,1596.0,54,26,27,0.481,188,0.287,5,0.295,9.2,216,57,156,0.264,383,0.564,32,0.615,5.7,270,83,183,0.307,571,0.473,37,0.506,6.4
438,201152,Thaddeus Young,1610612754,IND,73,40,33,2209.0,130,81,49,0.623,325,0.4,12,0.415,7.8,314,99,210,0.315,555,0.566,46,0.617,6.3,444,180,259,0.405,880,0.505,58,0.54,6.7
439,203080,Thomas Robinson,1610612747,LAL,48,15,33,560.0,84,54,29,0.643,186,0.452,3,0.459,6.1,139,40,98,0.288,207,0.671,13,0.716,4.7,223,94,127,0.422,393,0.567,16,0.592,5.2
440,1627748,Thon Maker,1610612749,MIL,57,31,26,562.0,40,25,14,0.625,89,0.449,0,0.449,7.2,74,29,45,0.392,179,0.413,24,0.477,5.6,114,54,59,0.474,266,0.429,24,0.471,6.2
441,201168,Tiago Splitter,1610612755,PHI,8,1,7,76.0,8,6,1,0.75,20,0.4,2,0.444,3.4,14,4,11,0.286,21,0.667,4,0.824,5.4,22,10,12,0.455,41,0.537,6,0.629,4.8
442,204025,Tim Frazier,1610612740,NOP,65,26,39,1525.0,34,16,18,0.471,157,0.217,9,0.23,9.9,139,22,121,0.158,337,0.412,40,0.468,8.0,173,38,139,0.22,494,0.35,49,0.389,8.3
443,203501,Tim Hardaway Jr.,1610612737,ATL,79,42,37,2154.0,35,14,18,0.4,155,0.226,5,0.233,12.0,189,39,149,0.206,352,0.537,23,0.574,8.1,224,53,167,0.237,507,0.442,28,0.468,8.8
444,1627817,Tim Quarterman,1610612757,POR,16,6,10,80.0,4,3,1,0.75,9,0.444,1,0.5,11.3,10,2,8,0.2,18,0.556,0,0.556,7.1,14,5,9,0.357,27,0.519,1,0.538,8.3
445,202389,Timofey Mozgov,1610612747,LAL,54,16,38,1104.0,104,63,38,0.606,263,0.395,9,0.409,5.6,160,60,100,0.375,321,0.498,43,0.576,5.3,264,123,138,0.466,584,0.452,52,0.496,5.5
446,1627789,Timothe Luwawu-Cabarrot,1610612755,PHI,69,23,46,1190.0,25,11,14,0.44,121,0.207,4,0.214,10.7,124,29,96,0.234,273,0.454,25,0.5,6.3,149,40,110,0.268,394,0.378,29,0.408,7.0
447,202699,Tobias Harris,1610612765,DET,82,37,45,2566.0,63,29,30,0.46,221,0.285,9,0.297,8.9,353,89,262,0.252,592,0.596,56,0.659,5.9,416,118,292,0.284,811,0.513,65,0.558,6.3
448,203107,Tomas Satoransky,1610612764,WAS,57,33,24,719.0,25,15,11,0.6,80,0.313,7,0.342,9.4,58,9,49,0.155,132,0.439,6,0.46,8.1,83,24,60,0.289,212,0.392,13,0.417,8.5
449,201962,Toney Douglas,1610612763,MEM,24,15,9,394.0,13,4,9,0.308,30,0.433,0,0.433,10.6,48,6,42,0.125,83,0.578,10,0.658,8.6,61,10,51,0.164,113,0.54,10,0.592,9.1
450,2754,Tony Allen,1610612763,MEM,71,36,35,1914.0,166,118,46,0.711,427,0.389,13,0.401,6.3,225,51,171,0.227,354,0.636,26,0.686,7.3,391,169,217,0.432,781,0.501,39,0.527,6.9
451,2225,Tony Parker,1610612759,SAS,62,46,16,1556.0,8,2,7,0.25,137,0.058,5,0.061,12.5,104,8,95,0.077,242,0.43,22,0.473,10.8,112,10,102,0.089,379,0.296,27,0.318,11.1
452,203503,Tony Snell,1610612749,MIL,80,42,38,2336.0,22,4,18,0.182,79,0.278,5,0.297,17.3,226,39,186,0.173,419,0.539,33,0.585,8.2,248,43,204,0.173,497,0.499,38,0.54,9.1
453,1626203,Treveon Graham,1610612766,CHA,27,10,17,189.0,5,3,2,0.6,20,0.25,0,0.25,11.6,17,3,14,0.176,33,0.515,4,0.586,6.3,22,6,16,0.273,53,0.415,4,0.449,7.5
454,2772,Trevor Ariza,1610612745,HOU,80,53,27,2773.0,54,23,31,0.426,207,0.261,7,0.27,12.3,404,110,294,0.272,652,0.62,48,0.669,6.4,458,133,325,0.29,858,0.534,55,0.57,7.1
455,202344,Trevor Booker,1610612751,BKN,70,18,52,1734.0,141,95,45,0.674,378,0.373,5,0.378,6.5,425,113,311,0.266,657,0.647,49,0.699,5.1,566,208,356,0.367,1032,0.548,54,0.579,5.4
456,203504,Trey Burke,1610612764,WAS,57,35,22,703.0,7,1,6,0.143,39,0.179,5,0.206,13.1,40,6,34,0.15,105,0.381,10,0.421,10.5,47,7,40,0.149,144,0.326,15,0.364,10.9
457,1626168,Trey Lyles,1610612762,UTA,71,43,28,1158.0,48,31,17,0.646,136,0.353,5,0.366,8.2,187,42,147,0.225,363,0.515,33,0.567,5.3,235,73,164,0.311,498,0.472,38,0.511,5.9
458,202684,Tristan Thompson,1610612739,CLE,78,50,28,2336.0,286,201,79,0.703,697,0.41,14,0.419,5.4,429,124,302,0.289,778,0.551,64,0.601,5.3,715,325,381,0.455,1473,0.485,78,0.513,5.3
459,203584,Troy Daniels,1610612763,MEM,67,33,34,1183.0,22,8,14,0.364,65,0.338,1,0.344,11.5,78,21,57,0.269,178,0.438,23,0.503,7.0,100,29,71,0.29,243,0.412,24,0.457,8.0
460,1627786,Troy Williams,1610612745,HOU,30,19,11,557.0,15,7,7,0.467,55,0.273,1,0.278,9.2,54,10,43,0.185,110,0.491,11,0.545,5.8,69,17,50,0.246,165,0.418,12,0.451,6.5
461,201951,Ty Lawson,1610612758,SAC,69,25,44,1732.0,44,16,28,0.364,152,0.289,4,0.297,11.8,135,9,127,0.067,247,0.547,16,0.584,10.6,179,25,155,0.14,398,0.45,20,0.474,10.9
462,203898,Tyler Ennis,1610612747,LAL,53,28,25,588.0,9,2,8,0.222,50,0.18,3,0.191,15.7,36,8,29,0.222,93,0.387,13,0.45,9.0,45,10,37,0.222,143,0.315,16,0.354,10.4
463,204020,Tyler Johnson,1610612748,MIA,73,35,38,2177.0,50,26,23,0.52,225,0.222,9,0.231,9.9,243,46,198,0.189,505,0.481,49,0.533,7.7,293,72,221,0.246,730,0.401,58,0.436,8.1
464,1627755,Tyler Ulis,1610612756,PHX,59,14,45,1103.0,19,3,15,0.158,101,0.188,4,0.196,18.5,75,7,68,0.093,166,0.452,13,0.49,10.3,94,10,83,0.106,267,0.352,17,0.376,12.0
465,203092,Tyler Zeller,1610612738,BOS,51,32,19,525.0,43,32,10,0.744,107,0.402,3,0.413,7.4,81,35,46,0.432,167,0.485,12,0.523,5.5,124,67,56,0.54,273,0.454,15,0.481,6.2
466,201936,Tyreke Evans,1610612758,SAC,40,17,23,788.0,13,6,7,0.462,91,0.143,3,0.148,5.9,124,30,95,0.242,203,0.611,12,0.649,6.4,137,36,102,0.263,294,0.466,15,0.491,6.5
467,2199,Tyson Chandler,1610612756,PHX,45,14,31,1229.0,138,95,40,0.688,310,0.445,10,0.46,5.4,367,114,250,0.311,538,0.682,35,0.73,4.2,505,209,290,0.414,845,0.598,45,0.631,4.5
468,1626145,Tyus Jones,1610612750,MIN,60,23,37,774.0,10,2,8,0.2,48,0.208,1,0.213,17.2,57,4,53,0.07,93,0.613,3,0.633,11.9,67,6,61,0.09,141,0.475,4,0.489,12.7
469,2617,Udonis Haslem,1610612748,MIA,16,6,10,130.0,8,6,2,0.75,25,0.32,0,0.32,9.4,28,9,17,0.321,45,0.622,9,0.778,4.1,36,15,19,0.417,70,0.514,9,0.59,5.4
470,203506,Victor Oladipo,1610612760,OKC,67,39,28,2223.0,39,11,27,0.282,149,0.262,5,0.271,14.9,252,37,216,0.147,474,0.532,56,0.603,7.1,291,48,243,0.165,622,0.468,61,0.519,8.1
471,1713,Vince Carter,1610612763,MEM,73,36,37,1800.0,36,20,15,0.556,147,0.245,1,0.247,8.9,191,46,146,0.241,374,0.511,33,0.56,7.0,227,66,161,0.291,520,0.437,34,0.467,7.3
472,1627735,Wade Baldwin IV,1610612763,MEM,33,18,15,405.0,11,5,6,0.455,40,0.275,2,0.289,10.6,35,4,31,0.114,75,0.467,10,0.538,7.4,46,9,37,0.196,115,0.4,12,0.447,8.1
473,201961,Wayne Ellington,1610612748,MIA,62,35,27,1500.0,18,5,14,0.278,85,0.212,2,0.217,15.9,114,17,95,0.149,220,0.518,14,0.553,8.0,132,22,109,0.167,305,0.433,16,0.457,9.2
474,1627782,Wayne Selden,1610612763,MEM,14,6,8,236.0,1,0,1,0.0,10,0.1,0,0.1,6.0,15,5,10,0.333,33,0.455,2,0.484,9.9,16,5,11,0.313,43,0.372,2,0.39,9.7
475,202325,Wesley Johnson,1610612746,LAC,68,40,28,810.0,26,6,19,0.231,55,0.473,0,0.473,13.9,155,42,113,0.271,261,0.594,18,0.638,5.8,181,48,132,0.265,315,0.575,18,0.609,6.9
476,202083,Wesley Matthews,1610612742,DAL,72,28,44,2457.0,18,3,15,0.167,117,0.154,5,0.161,16.4,241,41,201,0.17,443,0.544,34,0.589,7.6,259,44,216,0.17,559,0.463,39,0.498,8.2
477,203115,Will Barton,1610612743,DEN,59,30,29,1681.0,55,24,29,0.436,185,0.297,7,0.309,10.5,197,32,165,0.162,372,0.53,33,0.581,5.9,252,56,194,0.222,557,0.452,40,0.487,6.9
478,1626161,Willie Cauley-Stein,1610612758,SAC,75,29,46,1421.0,85,55,28,0.647,204,0.417,9,0.436,6.8,254,93,159,0.366,410,0.62,23,0.656,5.4,339,148,187,0.437,614,0.552,32,0.582,5.7
479,203186,Willie Reed,1610612748,MIA,71,39,32,1031.0,129,98,32,0.76,253,0.51,3,0.516,4.8,203,81,124,0.399,377,0.538,37,0.597,4.5,332,179,156,0.539,630,0.527,40,0.563,4.6
480,1626195,Willy Hernangomez,1610612752,NYK,72,27,45,1324.0,170,107,49,0.629,385,0.442,7,0.45,5.7,332,121,211,0.364,528,0.629,49,0.693,4.0,502,228,260,0.454,912,0.55,56,0.586,4.6
481,201163,Wilson Chandler,1610612743,DEN,70,34,36,2165.0,103,67,30,0.65,243,0.424,7,0.436,6.9,350,94,256,0.269,566,0.618,48,0.676,5.6,453,161,286,0.355,806,0.562,55,0.603,5.9
482,1627812,Yogi Ferrell,1610612742,DAL,46,18,28,1197.0,20,7,14,0.35,89,0.225,5,0.238,13.6,91,14,77,0.154,200,0.455,19,0.503,9.5,111,21,91,0.189,289,0.384,24,0.419,10.4
483,203897,Zach LaVine,1610612750,MIN,47,16,31,1749.0,19,2,15,0.105,117,0.162,7,0.173,19.2,141,12,131,0.085,267,0.528,22,0.576,8.3,160,14,146,0.088,384,0.417,29,0.451,9.5
484,2216,Zach Randolph,1610612763,MEM,73,38,35,1786.0,182,131,47,0.72,465,0.391,13,0.403,4.9,416,137,278,0.329,598,0.696,49,0.758,4.6,598,268,325,0.448,1058,0.565,62,0.6,4.7
485,2585,Zaza Pachulia,1610612744,GSW,70,58,12,1268.0,140,91,45,0.65,322,0.435,6,0.443,6.1,270,102,169,0.378,489,0.552,52,0.618,4.8,410,193,214,0.471,810,0.506,58,0.545,5.3
