,PLAYER_ID,PLAYER_NAME,TEAM_ID,TEAM_ABBREVIATION,GP,W,L,MIN,OREB,OREB_CONTEST,OREB_UNCONTEST,OREB_CONTEST_PCT,OREB_CHANCES,OREB_CHANCE_PCT,OREB_CHANCE_DEFER,OREB_CHANCE_PCT_ADJ,AVG_OREB_DIST,DREB,DREB_CONTEST,DREB_UNCONTEST,DREB_CONTEST_PCT,DREB_CHANCES,DREB_CHANCE_PCT,DREB_CHANCE_DEFER,DREB_CHANCE_PCT_ADJ,AVG_DREB_DIST,REB,REB_CONTEST,REB_UNCONTEST,REB_CONTEST_PCT,REB_CHANCES,REB_CHANCE_PCT,REB_CHANCE_DEFER,REB_CHANCE_PCT_ADJ,AVG_REB_DIST
0,201985,AJ Price,1610612750,MIN,28,15,13,99.0,1,0,1,0.0,6,0.167,0,0.167,27.2,9,1,9,0.111,16,0.563,1,0.6,12.9,10,1,10,0.1,22,0.455,1,0.476,14.2
1,201166,Aaron Brooks,1610612743,DEN,72,42,30,1557.0,43,14,29,0.326,134,0.321,9,0.344,13.1,97,14,87,0.144,247,0.393,24,0.435,11.2,140,28,116,0.2,381,0.367,33,0.402,11.8
2,201189,Aaron Gray,1610612758,SAC,36,11,25,348.0,41,27,13,0.659,98,0.418,5,0.441,5.0,68,24,44,0.353,125,0.544,14,0.613,5.2,109,51,57,0.468,223,0.489,19,0.534,5.2
3,203519,Adonis Thomas,1610612755,PHI,6,2,4,38.0,0,0,0,0.0,3,0.0,0,0.0,0.0,3,0,3,0.0,5,0.6,0,0.6,10.7,3,0,3,0.0,8,0.375,0,0.375,10.7
4,1733,Al Harrington,1610612764,WAS,33,20,13,497.0,15,8,6,0.533,55,0.273,7,0.313,7.3,63,18,45,0.286,122,0.516,10,0.563,7.3,78,26,51,0.333,177,0.441,17,0.488,7.3
5,201143,Al Horford,1610612737,ATL,29,16,13,958.0,66,36,28,0.545,132,0.5,5,0.52,7.5,178,73,98,0.41,301,0.591,24,0.643,6.1,244,109,126,0.447,433,0.564,29,0.604,6.5
6,2744,Al Jefferson,1610612766,CHA,72,37,35,2517.0,156,90,66,0.577,341,0.457,4,0.463,7.9,626,219,405,0.35,996,0.629,82,0.685,4.2,782,309,471,0.395,1337,0.585,86,0.625,4.9
7,202329,Al-Farouq Aminu,1610612740,NOP,80,33,47,2045.0,129,73,52,0.566,320,0.403,15,0.423,7.1,367,112,248,0.305,592,0.62,41,0.666,6.1,496,185,300,0.373,912,0.544,56,0.579,6.4
8,101187,Alan Anderson,1610612751,BKN,77,42,35,1745.0,40,19,18,0.475,140,0.286,4,0.294,10.6,134,32,99,0.239,304,0.441,34,0.496,8.7,174,51,117,0.293,444,0.392,38,0.429,9.2
9,202692,Alec Burks,1610612762,UTA,78,24,54,2193.0,59,34,24,0.576,229,0.258,10,0.269,11.1,198,46,155,0.232,393,0.504,26,0.54,7.2,257,80,179,0.311,622,0.413,36,0.439,8.0
10,203458,Alex Len,1610612756,PHX,42,24,18,362.0,39,25,12,0.641,98,0.398,4,0.415,5.3,60,27,33,0.45,123,0.488,5,0.508,3.8,99,52,45,0.525,221,0.448,9,0.467,4.4
11,203144,Alexey Shved,1610612750,MIN,63,28,35,664.0,21,9,12,0.429,82,0.256,3,0.266,8.9,60,17,44,0.283,97,0.619,10,0.69,8.5,81,26,56,0.321,179,0.453,13,0.488,8.6
12,201582,Alexis Ajinca,1610612740,NOP,56,22,34,951.0,94,60,35,0.638,231,0.407,5,0.416,6.3,183,68,115,0.372,303,0.604,33,0.678,4.3,277,128,150,0.462,534,0.519,38,0.558,5.0
13,203459,Allen Crabbe,1610612757,POR,15,12,3,100.0,1,0,1,0.0,10,0.1,1,0.111,6.8,8,1,7,0.125,14,0.571,0,0.571,6.5,9,1,8,0.111,24,0.375,1,0.391,6.5
14,202087,Alonzo Gee,1610612739,CLE,65,29,36,1020.0,35,15,21,0.429,125,0.28,4,0.289,9.4,114,21,92,0.184,209,0.545,18,0.597,8.1,149,36,113,0.242,334,0.446,22,0.478,8.4
15,2405,Amar'e Stoudemire,1610612752,NYK,65,26,39,1466.0,112,72,36,0.643,299,0.375,12,0.39,6.6,208,99,110,0.476,425,0.489,36,0.535,4.5,320,171,146,0.534,724,0.442,48,0.473,5.2
16,101161,Amir Johnson,1610612761,TOR,76,42,34,2181.0,167,127,32,0.76,463,0.361,19,0.376,5.0,330,146,179,0.442,689,0.479,67,0.531,4.9,497,273,211,0.549,1152,0.431,86,0.466,5.0
17,2760,Anderson Varejao,1610612739,CLE,65,25,40,1800.0,187,119,64,0.636,483,0.387,5,0.391,6.7,442,166,271,0.376,754,0.586,70,0.646,4.3,629,285,335,0.453,1237,0.508,75,0.541,5.0
18,101154,Andray Blatche,1610612751,BKN,72,39,33,1591.0,114,78,36,0.684,250,0.456,6,0.467,6.8,262,116,138,0.443,467,0.561,57,0.639,4.8,376,194,174,0.516,717,0.524,63,0.575,5.4
19,203083,Andre Drummond,1610612765,DET,81,29,52,2619.0,440,327,94,0.743,805,0.547,19,0.56,4.7,631,228,397,0.361,953,0.662,68,0.713,4.0,1071,555,491,0.518,1758,0.609,87,0.641,4.3
20,2738,Andre Iguodala,1610612744,GSW,63,41,22,2040.0,53,21,31,0.396,158,0.335,4,0.344,11.2,240,42,194,0.175,422,0.569,40,0.628,8.6,293,63,225,0.215,580,0.505,44,0.547,9.0
21,1889,Andre Miller,1610612764,WAS,57,32,25,968.0,28,17,11,0.607,117,0.239,7,0.255,11.7,101,15,86,0.149,196,0.515,18,0.567,8.6,129,32,97,0.248,313,0.412,25,0.448,9.2
22,203460,Andre Roberson,1610612760,OKC,40,30,10,399.0,36,17,17,0.472,86,0.419,4,0.439,7.0,58,14,44,0.241,112,0.518,10,0.569,6.1,94,31,61,0.33,198,0.475,14,0.511,6.5
23,200745,Andrea Bargnani,1610612752,NYK,42,15,27,1257.0,69,39,29,0.565,171,0.404,7,0.421,9.3,153,55,99,0.359,307,0.498,33,0.558,5.4,222,94,128,0.423,478,0.464,40,0.507,6.6
24,1905,Andrei Kirilenko,1610612751,BKN,44,29,15,836.0,53,27,26,0.509,156,0.34,7,0.356,7.8,89,23,64,0.258,150,0.593,13,0.65,6.6,142,50,90,0.352,306,0.464,20,0.497,7.1
25,101106,Andrew Bogut,1610612744,GSW,66,39,27,1745.0,180,121,59,0.672,364,0.495,7,0.504,5.3,479,203,271,0.424,802,0.597,58,0.644,3.9,659,324,330,0.492,1166,0.565,65,0.599,4.3
26,101115,Andrew Bynum,1610612754,IND,26,11,15,516.0,53,42,10,0.792,104,0.51,1,0.515,4.9,92,46,46,0.5,162,0.568,12,0.613,4.5,145,88,56,0.607,266,0.545,13,0.573,4.6
27,203094,Andrew Nicholson,1610612753,ORL,76,19,57,1174.0,53,32,22,0.604,119,0.445,3,0.457,7.8,202,87,115,0.431,402,0.502,51,0.575,5.1,255,119,137,0.467,521,0.489,54,0.546,5.6
28,2740,Andris Biedrins,1610612762,UTA,6,0,6,45.0,2,1,1,0.5,8,0.25,1,0.286,7.3,15,4,11,0.267,22,0.682,0,0.682,3.7,17,5,12,0.294,30,0.567,1,0.586,4.1
29,1712,Antawn Jamison,1610612746,LAC,22,15,7,248.0,9,8,1,0.889,32,0.281,1,0.29,4.8,46,16,29,0.348,90,0.511,3,0.529,5.5,55,24,30,0.436,122,0.451,4,0.466,5.4
30,203461,Anthony Bennett,1610612739,CLE,52,20,32,663.0,49,29,18,0.592,133,0.368,5,0.383,8.0,106,41,65,0.387,204,0.52,10,0.546,5.7,155,70,83,0.452,337,0.46,15,0.481,6.4
31,203076,Anthony Davis,1610612740,NOP,67,29,38,2358.0,207,131,74,0.633,415,0.499,5,0.505,6.2,466,195,272,0.418,691,0.674,50,0.727,5.0,673,326,346,0.484,1106,0.608,55,0.64,5.4
32,201627,Anthony Morrow,1610612740,NOP,76,32,44,1426.0,29,11,18,0.379,100,0.29,9,0.319,11.8,111,31,80,0.279,218,0.509,20,0.561,9.3,140,42,98,0.3,318,0.44,29,0.484,9.8
33,201576,Anthony Randolph,1610612743,DEN,43,15,28,527.0,20,13,5,0.65,62,0.323,2,0.333,5.4,102,29,74,0.284,170,0.6,13,0.65,5.6,122,42,79,0.344,232,0.526,15,0.562,5.6
34,201229,Anthony Tolliver,1610612766,CHA,63,32,31,1281.0,33,9,20,0.273,87,0.379,3,0.393,12.8,134,40,95,0.299,263,0.51,28,0.57,7.4,167,49,115,0.293,350,0.477,31,0.524,8.4
35,203462,Archie Goodwin,1610612756,PHX,52,32,20,533.0,25,14,11,0.56,83,0.301,6,0.325,8.9,62,13,49,0.21,123,0.504,12,0.559,7.1,87,27,60,0.31,206,0.422,18,0.463,7.6
36,202620,Arinze Onuaku,1610612739,CLE,5,2,3,30.0,2,2,0,1.0,4,0.5,0,0.5,4.9,6,1,5,0.167,8,0.75,1,0.857,5.3,8,3,5,0.375,12,0.667,1,0.727,5.2
37,203102,Arnett Moultrie,1610612755,PHI,12,0,12,187.0,11,4,7,0.364,35,0.314,2,0.333,8.0,24,10,14,0.417,48,0.5,4,0.545,5.3,35,14,21,0.4,83,0.422,6,0.455,6.1
38,203382,Aron Baynes,1610612759,SAS,53,41,12,491.0,57,39,17,0.684,144,0.396,1,0.399,5.4,88,43,44,0.489,139,0.633,10,0.682,5.0,145,82,61,0.566,283,0.512,11,0.533,5.2
39,201167,Arron Afflalo,1610612753,ORL,73,21,52,2552.0,32,11,24,0.344,193,0.166,4,0.169,13.4,230,28,202,0.122,437,0.526,39,0.578,8.7,262,39,226,0.149,630,0.416,43,0.446,9.3
40,201948,Austin Daye,1610612759,SAS,22,16,6,148.0,5,3,2,0.6,12,0.417,0,0.417,3.2,22,13,10,0.591,41,0.537,4,0.595,6.0,27,16,12,0.593,53,0.509,4,0.551,5.5
41,203085,Austin Rivers,1610612740,NOP,69,27,42,1339.0,26,11,15,0.423,119,0.218,4,0.226,11.8,103,19,84,0.184,257,0.401,31,0.456,8.0,129,30,99,0.233,376,0.343,35,0.378,8.8
42,202340,Avery Bradley,1610612738,BOS,60,19,41,1855.0,48,20,29,0.417,175,0.274,7,0.286,9.3,178,34,147,0.191,352,0.506,36,0.563,7.2,226,54,176,0.239,527,0.429,43,0.467,7.6
43,2732,Ben Gordon,1610612766,CHA,19,8,11,279.0,3,2,2,0.667,25,0.12,0,0.12,13.6,24,6,18,0.25,49,0.49,4,0.533,8.6,27,8,20,0.296,74,0.365,4,0.386,9.3
44,203463,Ben McLemore,1610612758,SAC,81,28,53,2169.0,53,14,39,0.264,190,0.279,9,0.293,14.3,182,31,149,0.17,449,0.405,64,0.473,8.6,235,45,188,0.191,639,0.368,73,0.415,9.9
45,2757,Beno Udrih,1610612763,MEM,41,18,23,643.0,10,3,8,0.3,41,0.244,6,0.286,16.6,49,10,39,0.204,114,0.43,8,0.462,10.4,59,13,47,0.22,155,0.381,14,0.418,11.4
46,203108,Bernard James,1610612742,DAL,30,17,13,146.0,15,13,2,0.867,39,0.385,0,0.385,5.4,27,17,10,0.63,55,0.491,2,0.509,3.4,42,30,12,0.714,94,0.447,2,0.457,4.1
47,202687,Bismack Biyombo,1610612766,CHA,76,41,35,1061.0,104,71,30,0.683,287,0.362,5,0.369,5.8,260,107,150,0.412,462,0.563,43,0.621,4.6,364,178,180,0.489,749,0.486,48,0.519,4.9
48,201933,Blake Griffin,1610612746,LAC,80,56,24,2863.0,192,123,61,0.641,510,0.376,23,0.394,6.6,565,226,335,0.4,964,0.586,75,0.636,4.9,757,349,396,0.461,1474,0.514,98,0.55,5.3
49,2564,Boris Diaw,1610612759,SAS,79,60,19,1974.0,74,45,27,0.608,226,0.327,10,0.343,7.6,252,93,159,0.369,522,0.483,52,0.536,6.1,326,138,186,0.423,748,0.436,62,0.475,6.4
50,203078,Bradley Beal,1610612764,WAS,72,40,32,2494.0,54,18,37,0.333,176,0.307,5,0.316,14.7,216,46,170,0.213,421,0.513,41,0.568,7.7,270,64,207,0.237,597,0.452,46,0.49,9.2
51,201148,Brandan Wright,1610612742,DAL,58,36,22,1077.0,102,68,32,0.667,205,0.498,6,0.513,7.2,142,63,80,0.444,278,0.511,30,0.573,5.2,244,131,112,0.537,483,0.505,36,0.546,6.0
52,101138,Brandon Bass,1610612738,BOS,82,25,57,2266.0,161,88,72,0.547,357,0.451,6,0.459,8.3,309,98,211,0.317,577,0.536,52,0.589,6.2,470,186,283,0.396,934,0.503,58,0.537,6.9
53,203561,Brandon Davies,1610612755,PHI,51,15,36,575.0,38,26,12,0.684,131,0.29,2,0.295,5.7,71,23,49,0.324,141,0.504,12,0.55,6.6,109,49,61,0.45,272,0.401,14,0.422,6.4
54,201943,Brandon Jennings,1610612765,DET,80,28,52,2728.0,59,26,37,0.441,214,0.276,7,0.285,13.6,185,13,175,0.07,364,0.508,24,0.544,10.7,244,39,212,0.16,578,0.422,31,0.446,11.4
55,202688,Brandon Knight,1610612749,MIL,72,13,59,2400.0,46,15,28,0.326,196,0.235,22,0.264,14.5,209,40,164,0.191,438,0.477,43,0.529,9.1,255,55,192,0.216,634,0.402,65,0.448,10.0
56,201575,Brandon Rush,1610612762,UTA,38,13,25,418.0,5,2,3,0.4,27,0.185,0,0.185,16.1,39,14,25,0.359,78,0.5,8,0.557,7.0,44,16,28,0.364,105,0.419,8,0.454,8.0
57,203148,Brian Roberts,1610612740,NOP,72,28,44,1667.0,17,4,13,0.235,96,0.177,6,0.189,17.8,119,13,106,0.109,232,0.513,18,0.556,11.2,136,17,119,0.125,328,0.415,24,0.447,12.0
58,201572,Brook Lopez,1610612751,BKN,17,7,10,533.0,39,28,9,0.718,95,0.411,2,0.419,5.9,63,30,31,0.476,143,0.441,23,0.525,5.8,102,58,40,0.569,238,0.429,25,0.479,5.8
59,201957,Byron Mullens,1610612755,PHI,45,16,29,414.0,24,14,10,0.583,53,0.453,0,0.453,7.5,68,21,46,0.309,120,0.567,16,0.654,4.4,92,35,56,0.38,173,0.532,16,0.586,5.2
60,201228,C.J. Watson,1610612754,IND,63,48,15,1193.0,19,4,14,0.211,64,0.297,4,0.317,15.7,82,13,71,0.159,175,0.469,14,0.509,9.7,101,17,85,0.168,239,0.423,18,0.457,10.7
61,203468,CJ McCollum,1610612757,POR,38,21,17,476.0,7,1,6,0.143,39,0.179,1,0.184,12.7,41,11,30,0.268,89,0.461,7,0.5,8.9,48,12,36,0.25,128,0.375,8,0.4,9.5
62,101139,CJ Miles,1610612739,CLE,51,21,30,984.0,18,6,13,0.333,67,0.269,3,0.281,16.8,85,21,65,0.247,165,0.515,12,0.556,8.7,103,27,78,0.262,232,0.444,15,0.475,10.1
63,201171,Carl Landry,1610612758,SAC,18,5,13,233.0,15,8,5,0.533,59,0.254,3,0.268,9.9,42,10,33,0.238,81,0.519,8,0.575,7.2,57,18,38,0.316,140,0.407,11,0.442,7.9
64,2430,Carlos Boozer,1610612741,CHI,76,43,33,2141.0,137,73,63,0.533,349,0.393,15,0.41,7.8,495,176,309,0.356,742,0.667,50,0.715,4.9,632,249,372,0.394,1091,0.579,65,0.616,5.5
65,2546,Carmelo Anthony,1610612752,NYK,77,35,42,2982.0,145,109,28,0.752,349,0.415,6,0.423,6.1,477,137,334,0.287,744,0.641,43,0.68,5.4,622,246,362,0.395,1093,0.569,49,0.596,5.6
66,2406,Caron Butler,1610612760,OKC,55,21,34,1394.0,21,13,10,0.619,94,0.223,4,0.233,9.6,202,61,143,0.302,358,0.564,29,0.614,6.2,223,74,153,0.332,452,0.493,33,0.532,6.6
67,203467,Carrick Felix,1610612739,CLE,7,2,5,38.0,1,1,0,1.0,5,0.2,0,0.2,13.9,5,1,4,0.2,9,0.556,2,0.714,8.0,6,2,4,0.333,14,0.429,2,0.5,9.0
68,201858,Cartier Martin,1610612737,ATL,59,27,32,870.0,13,8,4,0.615,60,0.217,0,0.217,10.8,97,22,73,0.227,188,0.516,21,0.581,7.4,110,30,77,0.273,248,0.444,21,0.485,7.8
69,203810,Casper Ware,1610612755,PHI,9,3,6,116.0,0,0,0,0.0,7,0.0,2,0.0,0.0,9,1,8,0.111,24,0.375,1,0.391,10.4,9,1,8,0.111,31,0.29,3,0.321,10.4
70,202718,Chandler Parsons,1610612745,HOU,74,50,24,2783.0,69,28,37,0.406,289,0.239,10,0.247,9.6,340,66,275,0.194,582,0.584,49,0.638,8.8,409,94,312,0.23,871,0.47,59,0.504,8.9
71,101112,Channing Frye,1610612756,PHX,82,48,34,2312.0,73,50,22,0.685,187,0.39,13,0.42,7.3,343,136,199,0.397,682,0.503,53,0.545,5.0,416,186,221,0.447,869,0.479,66,0.518,5.4
72,101111,Charlie Villanueva,1610612765,DET,20,5,15,180.0,6,5,1,0.833,24,0.25,1,0.261,8.9,28,12,16,0.429,51,0.549,5,0.609,4.4,34,17,17,0.5,75,0.453,6,0.493,5.2
73,201978,Chase Budinger,1610612750,MIN,41,21,20,751.0,19,9,9,0.474,55,0.345,3,0.365,9.9,84,20,63,0.238,126,0.667,6,0.7,5.9,103,29,72,0.282,181,0.569,9,0.599,6.6
74,1497,Chauncey Billups,1610612765,DET,19,7,12,309.0,4,2,1,0.5,13,0.308,0,0.308,8.7,24,2,22,0.083,53,0.453,5,0.5,8.0,28,4,23,0.143,66,0.424,5,0.459,8.1
75,2365,Chris Andersen,1610612748,MIA,72,49,23,1396.0,129,85,40,0.659,336,0.384,8,0.393,5.2,250,113,139,0.452,517,0.484,51,0.536,4.2,379,198,179,0.522,853,0.444,59,0.477,4.5
76,203569,Chris Babb,1610612738,BOS,14,3,11,132.0,4,2,2,0.5,10,0.4,1,0.444,11.4,13,5,8,0.385,28,0.464,2,0.5,6.0,17,7,10,0.412,38,0.447,3,0.486,7.2
77,2547,Chris Bosh,1610612748,MIA,79,53,26,2531.0,98,54,41,0.551,240,0.408,5,0.417,7.9,424,174,252,0.41,792,0.535,57,0.577,5.2,522,228,293,0.437,1032,0.506,62,0.538,5.7
78,203142,Chris Copeland,1610612754,IND,41,25,16,265.0,7,3,4,0.429,25,0.28,0,0.28,15.7,25,11,15,0.44,64,0.391,9,0.455,6.3,32,14,19,0.438,89,0.36,9,0.4,8.3
79,201604,Chris Douglas-Roberts,1610612766,CHA,48,26,22,994.0,15,4,10,0.267,63,0.238,0,0.238,15.4,101,31,70,0.307,177,0.571,21,0.647,7.8,116,35,80,0.302,240,0.483,21,0.53,8.7
80,203187,Chris Johnson,1610612738,BOS,40,11,29,789.0,31,16,14,0.516,101,0.307,2,0.313,8.4,66,15,51,0.227,150,0.44,16,0.493,6.7,97,31,65,0.32,251,0.386,18,0.416,7.2
81,2549,Chris Kaman,1610612747,LAL,39,13,26,736.0,54,36,16,0.667,140,0.386,9,0.412,6.7,175,68,107,0.389,309,0.566,29,0.625,4.1,229,104,123,0.454,449,0.51,38,0.557,4.7
82,101108,Chris Paul,1610612746,LAC,62,44,18,2171.0,38,10,29,0.263,165,0.23,9,0.244,15.9,230,36,197,0.157,459,0.501,31,0.537,9.9,268,46,226,0.172,624,0.429,40,0.459,10.7
83,202698,Chris Singleton,1610612764,WAS,25,13,12,250.0,18,9,8,0.5,55,0.327,3,0.346,7.1,37,7,30,0.189,71,0.521,8,0.587,7.2,55,16,38,0.291,126,0.437,11,0.478,7.2
84,203147,Chris Smith,1610612752,NYK,2,0,2,2.0,0,0,0,0.0,0,0.0,0,0.0,0.0,0,0,0,0.0,0,0.0,0,0.0,0.0,0,0,0,0.0,0,0.0,0,0.0,0.0
85,202874,Chris Wright,1610612749,MIL,8,1,7,126.0,10,5,4,0.5,23,0.435,0,0.435,6.4,10,5,5,0.5,34,0.294,3,0.323,6.8,20,10,9,0.5,57,0.351,3,0.37,6.6
86,101236,Chuck Hayes,1610612761,TOR,60,33,27,732.0,68,46,20,0.676,182,0.374,9,0.393,5.8,137,55,81,0.401,238,0.576,28,0.652,5.0,205,101,101,0.493,420,0.488,37,0.535,5.3
87,203469,Cody Zeller,1610612766,CHA,81,42,39,1400.0,115,67,42,0.583,316,0.364,9,0.375,5.8,231,80,150,0.346,447,0.517,40,0.568,5.2,346,147,192,0.425,763,0.453,49,0.485,5.4
88,202332,Cole Aldrich,1610612752,NYK,46,26,20,330.0,37,22,15,0.595,74,0.5,2,0.514,6.9,92,34,58,0.37,142,0.648,8,0.687,4.0,129,56,73,0.434,216,0.597,10,0.626,4.8
89,201147,Corey Brewer,1610612750,MIN,81,40,41,2609.0,63,20,38,0.317,249,0.253,9,0.263,12.1,144,28,114,0.194,268,0.537,30,0.605,9.5,207,48,152,0.232,517,0.4,39,0.433,10.3
90,202709,Cory Joseph,1610612759,SAS,68,52,16,936.0,32,18,13,0.563,83,0.386,1,0.39,10.8,75,20,56,0.267,166,0.452,14,0.493,9.3,107,38,69,0.355,249,0.43,15,0.457,9.7
91,201584,Courtney Lee,1610612763,MEM,79,47,32,1973.0,29,9,19,0.31,108,0.269,2,0.274,14.3,158,28,129,0.177,306,0.516,24,0.56,8.5,187,37,148,0.198,414,0.452,26,0.482,9.4
92,201571,D.J. Augustin,1610612741,CHI,70,43,27,1925.0,15,6,10,0.4,164,0.091,6,0.095,12.4,114,14,105,0.123,222,0.514,21,0.567,13.0,129,20,115,0.155,386,0.334,27,0.359,12.9
93,203474,DJ Stephens,1610612749,MIL,3,0,3,15.0,1,1,0,1.0,4,0.25,0,0.25,7.7,4,0,4,0.0,6,0.667,0,0.667,9.2,5,1,4,0.2,10,0.5,0,0.5,8.9
94,201591,DJ White,1610612766,CHA,2,2,0,10.0,0,0,0,0.0,1,0.0,0,0.0,0.0,2,0,2,0.0,2,1.0,0,1.0,8.1,2,0,2,0.0,3,0.667,0,0.667,8.1
95,203081,Damian Lillard,1610612757,POR,82,54,28,2937.0,35,12,23,0.343,245,0.143,11,0.15,14.9,253,44,214,0.174,587,0.431,68,0.487,8.4,288,56,237,0.194,832,0.346,79,0.382,9.2
96,202345,Damion James,1610612759,SAS,5,1,4,50.0,1,0,1,0.0,1,1.0,0,1.0,6.2,11,4,7,0.364,19,0.579,3,0.688,7.1,12,4,8,0.333,20,0.6,3,0.706,7.0
97,202350,Daniel Orton,1610612755,PHI,22,7,15,251.0,16,10,5,0.625,59,0.271,3,0.286,5.4,45,19,25,0.422,74,0.608,7,0.672,5.4,61,29,30,0.475,133,0.459,10,0.496,5.4
98,101122,Danny Granger,1610612746,LAC,41,31,10,848.0,31,19,10,0.613,127,0.244,4,0.252,7.5,102,24,76,0.235,197,0.518,21,0.58,6.4,133,43,86,0.323,324,0.41,25,0.445,6.7
99,201980,Danny Green,1610612759,SAS,68,54,14,1651.0,25,9,16,0.36,104,0.24,5,0.253,12.3,204,54,151,0.265,412,0.495,44,0.554,6.2,229,63,167,0.275,516,0.444,49,0.49,6.9
100,201967,Dante Cunningham,1610612750,MIN,81,39,42,1635.0,112,54,58,0.482,274,0.409,9,0.423,8.8,218,70,146,0.321,456,0.478,50,0.537,5.2,330,124,204,0.376,730,0.452,59,0.492,6.5
101,203130,Darius Johnson-Odom,1610612755,PHI,3,0,3,15.0,0,0,0,0.0,0,0.0,0,0.0,0.0,2,0,2,0.0,4,0.5,0,0.5,6.7,2,0,2,0.0,4,0.5,0,0.5,6.7
102,203121,Darius Miller,1610612740,NOP,45,14,31,723.0,9,3,5,0.333,40,0.225,0,0.225,17.5,43,13,31,0.302,93,0.462,11,0.524,9.9,52,16,36,0.308,133,0.391,11,0.426,11.1
103,202721,Darius Morris,1610612763,MEM,27,16,11,313.0,7,2,5,0.286,30,0.233,0,0.233,14.3,19,2,17,0.105,42,0.452,2,0.475,11.2,26,4,22,0.154,72,0.361,2,0.371,12.1
104,201589,Darrell Arthur,1610612743,DEN,68,33,35,1161.0,52,29,21,0.558,136,0.382,6,0.4,7.9,158,55,105,0.348,365,0.433,36,0.48,6.2,210,84,126,0.4,501,0.419,42,0.458,6.6
105,201954,Darren Collison,1610612746,LAC,80,56,24,2069.0,47,15,32,0.319,167,0.281,8,0.296,15.7,141,19,125,0.135,308,0.458,36,0.518,11.6,188,34,157,0.181,475,0.396,44,0.436,12.7
106,101135,David Lee,1610612744,GSW,68,41,27,2253.0,179,102,69,0.57,476,0.376,17,0.39,6.7,460,154,298,0.335,764,0.602,81,0.673,5.0,639,256,367,0.401,1240,0.515,98,0.56,5.4
107,2561,David West,1610612754,IND,80,54,26,2472.0,120,78,38,0.65,312,0.385,13,0.401,6.6,422,142,277,0.336,752,0.561,62,0.612,5.4,542,220,315,0.406,1064,0.509,75,0.548,5.7
108,201599,DeAndre Jordan,1610612746,LAC,82,57,25,2870.0,331,224,93,0.677,616,0.537,18,0.554,5.6,783,294,483,0.375,1202,0.651,76,0.695,4.9,1114,518,576,0.465,1818,0.613,94,0.646,5.1
109,202732,DeAndre Liggins,1610612748,MIA,1,1,0,1.0,1,0,1,0.0,1,1.0,0,1.0,1.4,0,0,0,0.0,0,0.0,0,0.0,0.0,1,0,1,0.0,1,1.0,0,1.0,1.4
110,201971,DeJuan Blair,1610612742,DAL,78,46,32,1214.0,139,94,42,0.676,351,0.396,7,0.404,6.2,229,95,131,0.415,395,0.58,47,0.658,4.0,368,189,173,0.514,746,0.493,54,0.532,4.9
111,201942,DeMar DeRozan,1610612761,TOR,78,44,34,2982.0,50,18,34,0.36,208,0.24,9,0.251,12.9,287,63,222,0.22,523,0.549,36,0.589,8.7,337,81,256,0.24,731,0.461,45,0.491,9.3
112,202326,DeMarcus Cousins,1610612758,SAC,70,28,42,2277.0,217,146,60,0.673,538,0.403,19,0.418,5.7,608,211,388,0.347,891,0.682,66,0.737,4.4,825,357,448,0.433,1429,0.577,85,0.614,4.7
113,201960,DeMarre Carroll,1610612737,ATL,73,37,36,2341.0,107,64,40,0.598,335,0.319,10,0.329,8.4,296,60,232,0.203,498,0.594,44,0.652,6.9,403,124,272,0.308,833,0.484,54,0.517,7.3
114,203471,Dennis Schroder,1610612737,ATL,48,21,27,622.0,5,1,4,0.2,40,0.125,3,0.135,15.4,54,7,48,0.13,129,0.419,16,0.478,8.4,59,8,52,0.136,169,0.349,19,0.393,9.0
115,965,Derek Fisher,1610612760,OKC,81,59,22,1428.0,12,4,7,0.333,64,0.188,2,0.194,15.9,110,26,84,0.236,219,0.502,15,0.539,10.6,122,30,91,0.246,283,0.431,17,0.459,11.1
116,101114,Deron Williams,1610612751,BKN,64,37,27,2059.0,15,3,12,0.2,108,0.139,4,0.144,18.9,153,25,132,0.163,359,0.426,20,0.451,10.0,168,28,144,0.167,467,0.36,24,0.379,10.8
117,202324,Derrick Favors,1610612762,UTA,73,25,48,2201.0,199,136,55,0.683,464,0.429,9,0.437,5.7,438,182,253,0.416,766,0.572,73,0.632,4.7,637,318,308,0.499,1230,0.518,82,0.555,5.0
118,201565,Derrick Rose,1610612741,CHI,10,5,5,311.0,9,5,3,0.556,49,0.184,1,0.188,7.2,23,2,20,0.087,49,0.469,5,0.523,11.5,32,7,23,0.219,98,0.327,6,0.348,10.3
119,202682,Derrick Williams,1610612758,SAC,77,29,48,1799.0,71,41,26,0.577,211,0.336,6,0.346,6.1,245,54,192,0.22,409,0.599,36,0.657,6.6,316,95,218,0.301,620,0.51,42,0.547,6.5
120,2734,Devin Harris,1610612742,DAL,40,24,16,818.0,8,1,7,0.125,47,0.17,1,0.174,15.1,77,16,60,0.208,144,0.535,14,0.592,8.9,85,17,67,0.2,191,0.445,15,0.483,9.5
121,203473,Dewayne Dedmon,1610612753,ORL,31,7,24,390.0,38,26,12,0.684,94,0.404,3,0.418,6.1,89,29,62,0.326,129,0.69,7,0.73,4.3,127,55,74,0.433,223,0.57,10,0.596,4.8
122,202354,Dexter Pittman,1610612737,ATL,2,0,2,3.0,3,2,0,0.667,3,1.0,0,1.0,1.7,0,0,0,0.0,0,0.0,0,0.0,0.0,3,2,0,0.667,3,1.0,0,1.0,1.7
123,203197,Diante Garrett,1610612762,UTA,71,23,48,1048.0,11,4,7,0.364,43,0.256,1,0.262,9.4,86,9,76,0.105,163,0.528,16,0.585,8.8,97,13,83,0.134,206,0.471,17,0.513,9.0
124,203079,Dion Waiters,1610612739,CLE,70,28,42,2072.0,32,12,21,0.375,161,0.199,2,0.201,13.0,163,35,126,0.215,314,0.519,29,0.572,9.0,195,47,147,0.241,475,0.411,31,0.439,9.7
125,202091,Dionte Christmas,1610612756,PHX,31,15,16,198.0,13,6,7,0.462,30,0.433,0,0.433,10.3,25,7,18,0.28,46,0.543,8,0.658,6.8,38,13,25,0.342,76,0.5,8,0.559,8.0
126,1717,Dirk Nowitzki,1610612742,DAL,80,48,32,2628.0,40,17,23,0.425,138,0.29,9,0.31,12.7,458,182,270,0.397,744,0.616,69,0.679,4.6,498,199,293,0.4,882,0.565,78,0.619,5.2
127,202388,Donald Sloan,1610612754,IND,48,31,17,392.0,4,1,3,0.25,20,0.2,3,0.235,6.5,40,3,36,0.075,63,0.635,2,0.656,9.8,44,4,39,0.091,83,0.53,5,0.564,9.5
128,202700,Donatas Motiejunas,1610612745,HOU,62,42,20,952.0,60,35,22,0.583,171,0.351,5,0.361,6.7,165,61,102,0.37,326,0.506,34,0.565,5.0,225,96,124,0.427,497,0.453,39,0.491,5.4
129,2748,Dorell Wright,1610612757,POR,68,48,20,984.0,29,10,19,0.345,81,0.358,1,0.363,14.2,162,48,113,0.296,295,0.549,31,0.614,6.1,191,58,132,0.304,376,0.508,32,0.555,7.3
130,203117,Doron Lamb,1610612753,ORL,53,13,40,695.0,8,1,7,0.125,36,0.222,1,0.229,17.3,41,11,30,0.268,93,0.441,5,0.466,10.5,49,12,37,0.245,129,0.38,6,0.398,11.6
131,203110,Draymond Green,1610612744,GSW,81,50,31,1775.0,84,60,21,0.714,220,0.382,14,0.408,6.7,320,131,183,0.409,554,0.578,47,0.631,4.6,404,191,204,0.473,774,0.522,61,0.567,5.1
132,2400,Drew Gooden,1610612764,WAS,21,12,9,377.0,35,19,17,0.543,80,0.438,2,0.449,7.6,71,24,46,0.338,131,0.542,13,0.602,4.5,106,43,63,0.406,211,0.502,15,0.541,5.5
133,202779,Dwight Buycks,1610612761,TOR,14,5,9,146.0,4,2,2,0.5,21,0.19,0,0.19,9.1,19,1,18,0.053,36,0.528,2,0.559,8.9,23,3,20,0.13,57,0.404,2,0.418,8.9
134,2730,Dwight Howard,1610612745,HOU,71,48,23,2396.0,231,166,55,0.719,549,0.421,13,0.431,4.9,635,256,372,0.403,1005,0.632,76,0.684,4.2,866,422,427,0.487,1554,0.557,89,0.591,4.4
135,2548,Dwyane Wade,1610612748,MIA,54,36,18,1775.0,60,31,28,0.517,170,0.353,2,0.357,10.1,181,38,140,0.21,350,0.517,37,0.578,9.6,241,69,168,0.286,520,0.463,39,0.501,9.7
136,202734,E'Twaun Moore,1610612753,ORL,79,22,57,1506.0,29,10,18,0.345,112,0.259,5,0.271,12.2,107,30,76,0.28,237,0.451,33,0.525,9.7,136,40,94,0.294,349,0.39,38,0.437,10.2
137,201947,Earl Clark,1610612752,NYK,54,22,32,768.0,22,10,12,0.455,84,0.262,2,0.268,11.0,121,38,83,0.314,218,0.555,18,0.605,5.4,143,48,95,0.336,302,0.474,20,0.507,6.3
138,2248,Earl Watson,1610612757,POR,24,17,7,161.0,5,2,3,0.4,10,0.5,1,0.556,14.6,10,0,10,0.0,30,0.333,1,0.345,11.4,15,2,13,0.133,40,0.375,2,0.395,12.4
139,202334,Ed Davis,1610612763,MEM,63,38,25,956.0,92,58,32,0.63,259,0.355,11,0.371,5.5,168,72,97,0.429,313,0.537,29,0.592,4.4,260,130,129,0.5,572,0.455,40,0.489,4.8
140,202327,Ekpe Udoh,1610612749,MIL,42,7,35,804.0,61,37,23,0.607,155,0.394,3,0.401,7.5,87,31,56,0.356,234,0.372,31,0.429,5.9,148,68,79,0.459,389,0.38,34,0.417,6.6
141,203548,Elias Harris,1610612747,LAL,2,1,1,11.0,1,0,1,0.0,1,1.0,0,1.0,26.5,0,0,0,0.0,0,0.0,0,0.0,0.0,1,0,1,0.0,1,1.0,0,1.0,26.5
142,202343,Elliot Williams,1610612755,PHI,67,13,54,1157.0,30,10,18,0.333,104,0.288,6,0.306,11.1,100,16,86,0.16,181,0.552,12,0.592,7.2,130,26,104,0.2,285,0.456,18,0.487,8.0
143,1882,Elton Brand,1610612737,ATL,72,34,38,1392.0,97,61,35,0.629,248,0.391,9,0.406,6.9,260,119,139,0.458,468,0.556,41,0.609,4.8,357,180,174,0.504,716,0.499,50,0.536,5.4
144,202683,Enes Kanter,1610612762,UTA,80,23,57,2138.0,222,169,45,0.761,555,0.4,15,0.411,4.9,376,166,212,0.441,696,0.54,70,0.601,4.5,598,335,257,0.56,1251,0.478,85,0.513,4.6
145,202339,Eric Bledsoe,1610612756,PHX,43,28,15,1416.0,27,8,18,0.296,119,0.227,7,0.241,12.0,175,31,145,0.177,315,0.556,21,0.595,8.8,202,39,163,0.193,434,0.465,28,0.498,9.2
146,201569,Eric Gordon,1610612740,NOP,64,26,38,2057.0,30,13,17,0.433,138,0.217,3,0.222,13.8,135,17,118,0.126,267,0.506,28,0.565,8.5,165,30,135,0.182,405,0.407,31,0.441,9.5
147,201953,Eric Maynor,1610612755,PHI,31,11,20,327.0,9,2,7,0.222,28,0.321,2,0.346,18.1,30,3,27,0.1,48,0.625,4,0.682,8.7,39,5,34,0.128,76,0.513,6,0.557,10.9
148,203513,Erik Murphy,1610612741,CHI,24,13,11,62.0,2,1,1,0.5,13,0.154,0,0.154,5.8,6,1,5,0.167,15,0.4,0,0.4,9.4,8,2,6,0.25,28,0.286,0,0.286,8.5
149,101141,Ersan Ilyasova,1610612749,MIL,54,10,44,1455.0,105,70,34,0.667,248,0.423,8,0.438,5.3,233,99,131,0.425,412,0.566,28,0.607,4.8,338,169,165,0.5,660,0.512,36,0.542,5.0
150,203095,Evan Fournier,1610612743,DEN,76,35,41,1503.0,34,16,18,0.471,152,0.224,10,0.239,10.2,168,38,130,0.226,321,0.523,21,0.56,8.2,202,54,148,0.267,473,0.427,31,0.457,8.6
151,202323,Evan Turner,1610612754,IND,81,29,52,2457.0,62,29,31,0.468,267,0.232,8,0.239,12.4,346,73,271,0.211,584,0.592,52,0.65,6.5,408,102,302,0.25,851,0.479,60,0.516,7.4
152,101128,Francisco Garcia,1610612745,HOU,55,33,22,1083.0,21,6,14,0.286,64,0.328,3,0.344,15.3,101,19,81,0.188,226,0.447,25,0.502,7.5,122,25,95,0.205,290,0.421,28,0.466,8.8
153,203539,Gal Mekel,1610612742,DAL,31,18,13,292.0,5,3,2,0.6,23,0.217,1,0.227,9.6,22,0,22,0.0,44,0.5,4,0.55,10.8,27,3,24,0.111,67,0.403,5,0.435,10.6
154,202066,Garrett Temple,1610612764,WAS,74,40,34,638.0,21,7,14,0.333,78,0.269,6,0.292,13.9,47,8,39,0.17,115,0.409,10,0.448,8.1,68,15,53,0.221,193,0.352,16,0.384,9.9
155,202390,Gary Neal,1610612766,CHA,51,19,32,1088.0,10,5,5,0.5,60,0.167,4,0.179,17.3,75,14,61,0.187,146,0.514,14,0.568,7.9,85,19,66,0.224,206,0.413,18,0.452,9.0
156,201588,George Hill,1610612754,IND,76,50,26,2434.0,53,21,32,0.396,143,0.371,6,0.387,13.8,230,41,188,0.178,499,0.461,42,0.503,8.0,283,62,220,0.219,642,0.441,48,0.476,9.2
157,101123,Gerald Green,1610612756,PHX,82,48,34,2330.0,48,17,30,0.354,153,0.314,5,0.324,11.5,227,55,169,0.242,428,0.53,29,0.569,7.8,275,72,199,0.262,581,0.473,34,0.503,8.5
158,201945,Gerald Henderson,1610612766,CHA,76,39,37,2434.0,31,9,22,0.29,181,0.171,2,0.173,12.3,278,55,220,0.198,440,0.632,25,0.67,7.4,309,64,242,0.207,621,0.498,27,0.52,7.9
159,2222,Gerald Wallace,1610612738,BOS,58,19,39,1416.0,36,24,11,0.667,135,0.267,4,0.275,5.6,176,51,126,0.29,299,0.589,26,0.645,6.5,212,75,137,0.354,434,0.488,30,0.525,6.4
160,203507,Giannis Antetokounmpo,1610612749,MIL,76,14,62,1880.0,78,39,39,0.5,246,0.317,13,0.335,7.9,259,73,185,0.282,497,0.521,36,0.562,5.8,337,112,224,0.332,743,0.454,49,0.486,6.3
161,203540,Gigi Datome,1610612765,DET,34,9,25,238.0,14,8,5,0.571,40,0.35,1,0.359,8.0,32,11,21,0.344,60,0.533,3,0.561,6.8,46,19,26,0.413,100,0.46,4,0.479,7.2
162,201175,Glen Davis,1610612746,LAC,68,30,38,1662.0,108,65,40,0.602,260,0.415,7,0.427,6.9,243,107,134,0.44,478,0.508,58,0.579,5.1,351,172,174,0.49,738,0.476,65,0.522,5.7
163,203318,Glen Rice,1610612764,WAS,11,2,9,109.0,4,1,3,0.25,12,0.333,1,0.364,22.5,16,4,12,0.25,20,0.8,0,0.8,10.6,20,5,15,0.25,32,0.625,1,0.645,13.0
164,201609,Goran Dragic,1610612756,PHX,76,45,31,2668.0,69,24,45,0.348,237,0.291,19,0.317,13.7,176,24,154,0.136,401,0.439,29,0.473,11.0,245,48,199,0.196,638,0.384,48,0.415,11.9
165,202330,Gordon Hayward,1610612762,UTA,77,23,54,2800.0,62,26,36,0.419,217,0.286,10,0.3,11.3,329,75,252,0.228,566,0.581,43,0.629,8.5,391,101,288,0.258,783,0.499,53,0.536,8.9
166,203476,Gorgui Dieng,1610612750,MIN,60,32,28,818.0,103,72,28,0.699,252,0.409,4,0.415,5.7,197,79,116,0.401,300,0.657,21,0.706,4.4,300,151,144,0.503,552,0.543,25,0.569,4.8
167,202328,Greg Monroe,1610612765,DET,82,29,53,2689.0,256,175,67,0.684,654,0.391,24,0.406,5.7,504,229,275,0.454,857,0.588,92,0.659,4.8,760,404,342,0.532,1511,0.503,116,0.545,5.1
168,201141,Greg Oden,1610612748,MIA,23,16,7,212.0,23,14,9,0.609,56,0.411,1,0.418,10.3,31,9,22,0.29,70,0.443,7,0.492,5.4,54,23,31,0.426,126,0.429,8,0.458,7.5
169,202962,Greg Smith,1610612745,HOU,11,7,4,100.0,11,8,3,0.727,27,0.407,1,0.423,4.0,16,4,12,0.25,32,0.5,3,0.552,5.1,27,12,15,0.444,59,0.458,4,0.491,4.6
170,201880,Greg Stiemsma,1610612740,NOP,55,21,34,1007.0,72,32,36,0.444,172,0.419,4,0.429,6.4,154,60,93,0.39,313,0.492,32,0.548,3.5,226,92,129,0.407,485,0.466,36,0.503,4.4
171,202349,Greivis Vasquez,1610612761,TOR,78,46,32,1765.0,19,6,12,0.316,115,0.165,3,0.17,17.6,153,32,121,0.209,326,0.469,28,0.513,8.6,172,38,133,0.221,441,0.39,31,0.42,9.6
172,202970,Gustavo Ayon,1610612737,ATL,25,12,13,421.0,40,22,17,0.55,108,0.37,3,0.381,5.9,82,35,46,0.427,147,0.558,12,0.607,4.2,122,57,63,0.467,255,0.478,15,0.508,4.7
173,202380,Hamady Ndiaye,1610612758,SAC,14,5,9,74.0,5,2,1,0.4,17,0.294,1,0.313,3.9,13,5,8,0.385,23,0.565,3,0.65,5.7,18,7,9,0.389,40,0.45,4,0.5,5.4
174,203084,Harrison Barnes,1610612744,GSW,77,47,30,2165.0,66,26,41,0.394,196,0.337,6,0.347,10.4,245,60,184,0.245,497,0.493,61,0.562,7.2,311,86,225,0.277,693,0.449,67,0.497,7.9
175,201934,Hasheem Thabeet,1610612760,OKC,23,18,5,192.0,9,5,4,0.556,22,0.409,0,0.409,6.3,31,12,19,0.387,59,0.525,7,0.596,4.9,40,17,23,0.425,81,0.494,7,0.541,5.3
176,2045,Hedo Turkoglu,1610612746,LAC,38,27,11,392.0,11,6,5,0.545,40,0.275,2,0.289,9.8,78,24,54,0.308,137,0.569,11,0.619,5.7,89,30,59,0.337,177,0.503,13,0.543,6.2
177,203156,Henry Sims,1610612755,PHI,46,11,35,875.0,104,70,30,0.673,257,0.405,10,0.421,4.9,133,51,81,0.383,296,0.449,30,0.5,4.9,237,121,111,0.511,553,0.429,40,0.462,4.9
178,200756,Hilton Armstrong,1610612744,GSW,15,12,3,97.0,19,18,1,0.947,36,0.528,2,0.559,5.0,28,15,13,0.536,39,0.718,2,0.757,3.9,47,33,14,0.702,75,0.627,4,0.662,4.4
179,203138,Hollis Thompson,1610612755,PHI,77,18,59,1742.0,73,36,35,0.493,195,0.374,3,0.38,10.1,174,53,121,0.305,322,0.54,23,0.582,7.0,247,89,156,0.36,517,0.478,26,0.503,7.9
180,203546,Ian Clark,1610612762,UTA,23,3,20,172.0,3,2,1,0.667,18,0.167,0,0.167,17.8,16,4,12,0.25,29,0.552,3,0.615,9.6,19,6,13,0.316,47,0.404,3,0.432,10.9
181,101133,Ian Mahinmi,1610612754,IND,77,51,26,1248.0,107,75,30,0.701,299,0.358,9,0.369,6.0,150,66,84,0.44,383,0.392,40,0.437,5.6,257,141,114,0.549,682,0.377,49,0.406,5.8
182,202697,Iman Shumpert,1610612752,NYK,74,36,38,1962.0,81,41,41,0.506,240,0.338,6,0.346,10.3,227,52,174,0.229,421,0.539,40,0.596,6.8,308,93,215,0.302,661,0.466,46,0.501,7.7
183,203477,Isaiah Canaan,1610612745,HOU,22,14,8,252.0,7,3,4,0.429,27,0.259,3,0.292,16.2,17,2,15,0.118,36,0.472,4,0.531,9.4,24,5,19,0.208,63,0.381,7,0.429,11.4
184,202738,Isaiah Thomas,1610612758,SAC,71,26,45,2463.0,44,15,30,0.341,196,0.224,11,0.238,13.5,161,18,146,0.112,397,0.406,31,0.44,11.9,205,33,176,0.161,593,0.346,42,0.372,12.3
185,202397,Ish Smith,1610612756,PHX,70,39,31,1006.0,31,15,16,0.484,107,0.29,9,0.316,9.0,98,23,75,0.235,217,0.452,27,0.516,7.6,129,38,91,0.295,324,0.398,36,0.448,7.9
186,200826,J.J. Barea,1610612750,MIN,79,40,39,1471.0,16,5,11,0.313,137,0.117,10,0.126,13.3,138,16,123,0.116,274,0.504,22,0.548,9.1,154,21,134,0.136,411,0.375,32,0.406,9.5
187,201581,JJ Hickson,1610612743,DEN,69,31,38,1859.0,206,124,74,0.602,463,0.445,9,0.454,6.3,426,142,284,0.333,673,0.633,56,0.69,5.6,632,266,358,0.421,1136,0.556,65,0.59,5.8
188,200755,JJ Redick,1610612746,LAC,35,24,11,987.0,9,1,9,0.111,57,0.158,1,0.161,17.8,65,13,52,0.2,160,0.406,6,0.422,8.8,74,14,61,0.189,217,0.341,7,0.352,10.1
189,2747,JR Smith,1610612752,NYK,74,34,40,2421.0,35,11,24,0.314,155,0.226,5,0.233,15.4,261,46,218,0.176,415,0.629,28,0.674,7.6,296,57,242,0.193,570,0.519,33,0.551,8.5
190,201580,JaVale McGee,1610612743,DEN,5,1,4,79.0,10,2,8,0.2,21,0.476,1,0.5,7.0,7,4,3,0.571,24,0.292,7,0.412,4.4,17,6,11,0.353,45,0.378,8,0.459,5.9
191,203109,Jae Crowder,1610612742,DAL,78,47,31,1254.0,46,30,16,0.652,120,0.383,6,0.404,8.9,148,34,113,0.23,297,0.498,32,0.558,6.6,194,64,129,0.33,417,0.465,38,0.512,7.1
192,203479,Jamaal Franklin,1610612763,MEM,21,11,10,162.0,4,2,1,0.5,6,0.667,0,0.667,8.7,19,3,16,0.158,33,0.576,5,0.679,5.8,23,5,17,0.217,39,0.59,5,0.676,6.2
193,2224,Jamaal Tinsley,1610612762,UTA,8,0,8,110.0,2,1,1,0.5,5,0.4,0,0.4,14.7,9,1,8,0.111,18,0.5,1,0.529,9.2,11,2,9,0.182,23,0.478,1,0.5,10.2
194,2037,Jamal Crawford,1610612746,LAC,69,47,22,2094.0,34,10,23,0.294,100,0.34,7,0.366,14.9,124,11,115,0.089,255,0.486,11,0.508,12.2,158,21,138,0.133,355,0.445,18,0.469,12.8
195,2749,Jameer Nelson,1610612753,ORL,68,21,47,2179.0,29,6,23,0.207,131,0.221,6,0.232,12.5,202,25,178,0.124,387,0.522,26,0.56,10.1,231,31,201,0.134,518,0.446,32,0.475,10.4
196,202341,James Anderson,1610612755,PHI,80,19,61,2309.0,59,29,31,0.492,189,0.312,5,0.321,10.0,241,48,194,0.199,469,0.514,44,0.567,6.9,300,77,225,0.257,658,0.456,49,0.493,7.5
197,201935,James Harden,1610612745,HOU,73,48,25,2777.0,61,23,39,0.377,230,0.265,9,0.276,11.2,283,63,223,0.223,531,0.533,41,0.578,8.9,344,86,262,0.25,761,0.452,50,0.484,9.4
198,201949,James Johnson,1610612763,MEM,52,33,19,956.0,60,27,31,0.45,153,0.392,2,0.397,8.5,106,24,81,0.226,220,0.482,21,0.533,6.7,166,51,112,0.307,373,0.445,23,0.474,7.4
199,2592,James Jones,1610612748,MIA,20,15,5,236.0,2,1,1,0.5,17,0.118,2,0.133,34.9,21,6,15,0.286,50,0.42,5,0.467,7.3,23,7,16,0.304,67,0.343,7,0.383,9.7
200,203263,James Nunnally,1610612755,PHI,12,3,9,157.0,1,0,1,0.0,7,0.143,0,0.143,10.4,18,0,18,0.0,40,0.45,1,0.462,8.7,19,0,19,0.0,47,0.404,1,0.413,8.8
201,203480,James Southerland,1610612740,NOP,4,2,2,30.0,0,0,0,0.0,3,0.0,0,0.0,0.0,8,1,7,0.125,13,0.615,0,0.615,6.1,8,1,7,0.125,16,0.5,0,0.5,6.1
202,202686,Jan Vesely,1610612743,DEN,54,22,32,776.0,81,45,34,0.556,191,0.424,9,0.445,7.3,110,45,67,0.409,232,0.474,23,0.526,5.2,191,90,101,0.471,423,0.452,32,0.488,6.1
203,2457,Jannero Pargo,1610612766,CHA,29,15,14,242.0,1,0,1,0.0,8,0.125,0,0.125,21.6,19,2,17,0.105,38,0.5,5,0.576,10.6,20,2,18,0.1,46,0.435,5,0.488,11.2
204,203099,Jared Cunningham,1610612758,SAC,13,5,8,80.0,1,1,0,1.0,10,0.1,1,0.111,1.5,5,3,1,0.6,13,0.385,3,0.5,4.5,6,4,1,0.667,23,0.261,4,0.316,3.9
205,201162,Jared Dudley,1610612746,LAC,74,51,23,1729.0,36,11,25,0.306,147,0.245,10,0.263,11.9,124,26,97,0.21,318,0.39,28,0.428,7.9,160,37,122,0.231,465,0.344,38,0.375,8.8
206,203096,Jared Sullinger,1610612738,BOS,74,23,51,2041.0,241,185,48,0.768,510,0.473,13,0.485,4.9,360,166,192,0.461,644,0.559,44,0.6,4.3,601,351,240,0.584,1154,0.521,57,0.548,4.5
207,101127,Jarrett Jack,1610612739,CLE,80,32,48,2252.0,22,4,19,0.182,125,0.176,3,0.18,17.3,201,26,175,0.129,408,0.493,34,0.537,9.1,223,30,194,0.135,533,0.418,37,0.45,10.0
208,202363,Jarvis Varnado,1610612755,PHI,24,5,19,339.0,19,15,4,0.789,61,0.311,5,0.339,6.9,44,19,25,0.432,108,0.407,11,0.454,4.5,63,34,29,0.54,169,0.373,16,0.412,5.4
209,2215,Jason Collins,1610612751,BKN,22,16,6,172.0,7,5,2,0.714,21,0.333,0,0.333,6.5,12,3,9,0.25,41,0.293,3,0.316,7.8,19,8,11,0.421,62,0.306,3,0.322,7.3
210,101131,Jason Maxiell,1610612753,ORL,34,7,27,488.0,28,20,6,0.714,113,0.248,5,0.259,5.1,58,22,36,0.379,135,0.43,13,0.475,6.1,86,42,42,0.488,248,0.347,18,0.374,5.8
211,201160,Jason Smith,1610612740,NOP,31,11,20,830.0,51,18,31,0.353,110,0.464,4,0.481,11.0,130,54,75,0.415,230,0.565,13,0.599,6.0,181,72,106,0.398,340,0.532,17,0.56,7.4
212,1891,Jason Terry,1610612751,BKN,34,16,18,544.0,4,1,4,0.25,27,0.148,1,0.154,10.8,32,2,30,0.063,70,0.457,5,0.492,10.4,36,3,34,0.083,97,0.371,6,0.396,10.8
213,201574,Jason Thompson,1610612758,SAC,81,28,53,1979.0,151,95,50,0.629,438,0.345,19,0.36,5.9,369,121,244,0.328,682,0.541,84,0.617,5.4,520,216,294,0.415,1120,0.464,103,0.511,5.5
214,202399,Jeff Adrien,1610612749,MIL,53,17,36,962.0,102,78,23,0.765,251,0.406,9,0.421,4.1,204,82,119,0.402,335,0.609,20,0.648,4.1,306,160,142,0.523,586,0.522,29,0.549,4.1
215,201965,Jeff Ayres,1610612759,SAS,73,55,18,952.0,89,52,32,0.584,205,0.434,5,0.445,5.8,169,68,100,0.402,338,0.5,41,0.569,3.9,258,120,132,0.465,543,0.475,46,0.519,4.6
216,201145,Jeff Green,1610612738,BOS,82,25,57,2805.0,54,27,23,0.5,235,0.23,9,0.239,10.1,326,83,239,0.255,587,0.555,51,0.608,6.4,380,110,262,0.289,822,0.462,60,0.499,6.9
217,201952,Jeff Teague,1610612737,ATL,78,37,41,2514.0,33,13,22,0.394,187,0.176,11,0.188,13.5,173,17,155,0.098,369,0.469,34,0.516,10.4,206,30,177,0.146,556,0.371,45,0.403,10.9
218,203481,Jeff Withey,1610612740,NOP,58,21,37,684.0,49,28,18,0.571,135,0.363,7,0.383,5.1,101,47,53,0.465,229,0.441,21,0.486,4.4,150,75,71,0.5,364,0.412,28,0.446,4.6
219,203106,Jeffery Taylor,1610612766,CHA,26,12,14,629.0,15,9,6,0.6,70,0.214,0,0.214,11.1,45,7,38,0.156,105,0.429,13,0.489,9.0,60,16,44,0.267,175,0.343,13,0.37,9.6
220,202379,Jeremy Evans,1610612762,UTA,66,23,43,1209.0,120,76,41,0.633,261,0.46,9,0.476,6.4,190,62,124,0.326,382,0.497,49,0.571,5.2,310,138,165,0.445,643,0.482,58,0.53,5.7
221,203087,Jeremy Lamb,1610612760,OKC,78,57,21,1538.0,27,10,15,0.37,118,0.229,5,0.239,10.3,162,42,120,0.259,329,0.492,29,0.54,5.5,189,52,135,0.275,447,0.423,34,0.458,6.2
222,202391,Jeremy Lin,1610612745,HOU,71,48,23,2054.0,34,6,24,0.176,172,0.198,7,0.206,17.4,153,35,117,0.229,411,0.372,47,0.42,8.8,187,41,141,0.219,583,0.321,54,0.353,10.3
223,202719,Jeremy Tyler,1610612752,NYK,41,20,21,398.0,38,24,14,0.632,97,0.392,3,0.404,6.1,71,38,32,0.535,128,0.555,10,0.602,4.7,109,62,46,0.569,225,0.484,13,0.514,5.2
224,979,Jermaine O'Neal,1610612744,GSW,43,26,17,862.0,83,51,30,0.614,210,0.395,2,0.399,6.0,156,60,92,0.385,307,0.508,25,0.553,4.7,239,111,122,0.464,517,0.462,27,0.488,5.2
225,201573,Jerryd Bayless,1610612738,BOS,72,24,48,1686.0,22,3,17,0.136,95,0.232,7,0.25,19.7,123,25,98,0.203,257,0.479,22,0.523,9.1,145,28,115,0.193,352,0.412,29,0.449,10.5
226,202690,Jimmer Fredette,1610612741,CHI,49,20,29,519.0,8,4,3,0.5,31,0.258,2,0.276,14.1,44,1,43,0.023,78,0.564,8,0.629,11.1,52,5,46,0.096,109,0.477,10,0.525,11.5
227,202710,Jimmy Butler,1610612741,CHI,67,43,24,2590.0,87,44,37,0.506,252,0.345,14,0.366,10.5,243,68,173,0.28,523,0.465,53,0.517,7.7,330,112,210,0.339,775,0.426,67,0.466,8.4
228,201149,Joakim Noah,1610612741,CHI,80,48,32,2820.0,282,188,91,0.667,687,0.41,19,0.422,6.5,618,243,377,0.393,1110,0.557,87,0.604,4.0,900,431,468,0.479,1797,0.501,106,0.532,4.8
229,201975,Jodie Meeks,1610612747,LAL,77,25,52,2556.0,30,11,19,0.367,143,0.21,6,0.219,14.0,164,23,142,0.14,326,0.503,19,0.534,10.9,194,34,161,0.175,469,0.414,25,0.437,11.4
230,2207,Joe Johnson,1610612751,BKN,78,42,36,2544.0,46,29,17,0.63,150,0.307,7,0.322,10.4,220,51,171,0.232,386,0.57,20,0.601,8.2,266,80,188,0.301,536,0.496,27,0.523,8.6
231,201202,Joel Anthony,1610612738,BOS,33,16,17,186.0,15,9,6,0.6,34,0.441,1,0.455,6.5,23,5,18,0.217,59,0.39,9,0.46,3.8,38,14,24,0.368,93,0.409,10,0.458,4.9
232,200777,Joel Freeland,1610612757,POR,52,37,15,727.0,88,53,35,0.602,214,0.411,3,0.417,7.0,120,47,74,0.392,256,0.469,32,0.536,4.7,208,100,109,0.481,470,0.443,35,0.478,5.6
233,203089,John Henson,1610612749,MIL,69,12,57,1832.0,170,104,60,0.612,347,0.49,4,0.496,6.6,324,143,177,0.441,577,0.562,33,0.596,4.7,494,247,237,0.5,924,0.535,37,0.557,5.4
234,203098,John Jenkins,1610612737,ATL,13,6,7,158.0,3,2,2,0.667,14,0.214,0,0.214,6.3,19,4,15,0.211,42,0.452,7,0.543,7.9,22,6,17,0.273,56,0.393,7,0.449,8.0
235,101249,John Lucas III,1610612762,UTA,42,10,32,591.0,12,2,11,0.167,24,0.5,1,0.522,18.5,27,2,25,0.074,64,0.422,4,0.45,12.2,39,4,36,0.103,88,0.443,5,0.47,14.3
236,2422,John Salmons,1610612761,TOR,77,46,31,1699.0,20,6,13,0.3,88,0.227,1,0.23,15.4,142,36,105,0.254,303,0.469,23,0.507,7.1,162,42,118,0.259,391,0.414,24,0.441,8.1
237,202322,John Wall,1610612764,WAS,81,44,37,2945.0,37,13,25,0.351,241,0.154,23,0.17,16.3,294,40,255,0.136,549,0.536,25,0.561,9.8,331,53,280,0.16,790,0.419,48,0.446,10.6
238,202720,Jon Leuer,1610612763,MEM,49,24,25,642.0,37,22,17,0.595,115,0.322,1,0.325,6.2,121,39,80,0.322,203,0.596,19,0.658,4.7,158,61,97,0.386,318,0.497,20,0.53,5.1
239,201973,Jonas Jerebko,1610612765,DET,64,23,41,741.0,51,40,9,0.784,136,0.375,8,0.398,7.1,124,45,78,0.363,218,0.569,22,0.633,6.1,175,85,87,0.486,354,0.494,30,0.54,6.4
240,202685,Jonas Valanciunas,1610612761,TOR,80,46,34,2266.0,223,161,58,0.722,630,0.354,10,0.36,4.7,485,190,293,0.392,873,0.556,82,0.613,3.7,708,351,351,0.496,1503,0.471,92,0.502,4.0
241,202348,Jordan Crawford,1610612744,GSW,81,39,42,1860.0,28,10,15,0.357,116,0.241,7,0.257,11.9,155,15,140,0.097,291,0.533,22,0.576,10.1,183,25,155,0.137,407,0.45,29,0.484,10.4
242,200770,Jordan Farmar,1610612747,LAL,41,16,25,912.0,20,9,11,0.45,64,0.313,3,0.328,11.3,84,10,75,0.119,165,0.509,11,0.545,10.3,104,19,86,0.183,229,0.454,14,0.484,10.5
243,202706,Jordan Hamilton,1610612745,HOU,60,31,29,1020.0,32,16,17,0.5,104,0.308,3,0.317,15.0,162,36,124,0.222,312,0.519,34,0.583,5.8,194,52,141,0.268,416,0.466,37,0.512,7.4
244,201941,Jordan Hill,1610612747,LAL,72,24,48,1500.0,194,150,43,0.773,517,0.375,13,0.385,5.4,341,142,195,0.416,603,0.566,49,0.616,4.3,535,292,238,0.546,1120,0.478,62,0.506,4.7
245,203268,Jorge Gutierrez,1610612751,BKN,15,8,7,244.0,3,1,2,0.333,18,0.167,2,0.188,13.3,19,2,14,0.105,40,0.475,4,0.528,6.9,22,3,16,0.136,58,0.379,6,0.423,7.9
246,101181,Jose Calderon,1610612742,DAL,81,49,32,2468.0,29,2,27,0.069,83,0.349,4,0.367,20.9,163,28,139,0.172,398,0.41,28,0.441,11.6,192,30,166,0.156,481,0.399,32,0.428,13.1
247,2735,Josh Childress,1610612740,NOP,4,2,2,24.0,0,0,0,0.0,4,0.0,0,0.0,0.0,3,1,2,0.333,5,0.6,0,0.6,2.7,3,1,2,0.333,9,0.333,0,0.333,2.7
248,202725,Josh Harrellson,1610612765,DET,32,12,20,317.0,30,17,10,0.567,60,0.5,3,0.526,5.8,46,21,22,0.457,93,0.495,13,0.575,4.6,76,38,32,0.5,153,0.497,16,0.555,5.1
249,201177,Josh McRoberts,1610612766,CHA,77,38,39,2329.0,84,43,40,0.512,214,0.393,5,0.402,8.3,284,104,181,0.366,666,0.426,68,0.475,5.8,368,147,221,0.399,880,0.418,73,0.456,6.4
250,2694,Josh Powell,1610612745,HOU,1,0,1,19.0,0,0,0,0.0,3,0.0,0,0.0,0.0,5,3,2,0.6,6,0.833,0,0.833,7.7,5,3,2,0.6,9,0.556,0,0.556,7.7
251,2746,Josh Smith,1610612765,DET,77,28,49,2730.0,102,69,32,0.676,313,0.326,13,0.34,6.8,418,160,256,0.383,726,0.576,70,0.637,6.2,520,229,288,0.44,1039,0.5,83,0.544,6.3
252,201950,Jrue Holiday,1610612740,NOP,34,15,19,1143.0,28,14,14,0.5,104,0.269,8,0.292,11.5,114,22,93,0.193,212,0.538,23,0.603,9.0,142,36,107,0.254,316,0.449,31,0.498,9.5
253,202933,Julyan Stone,1610612761,TOR,21,9,12,120.0,2,2,0,1.0,10,0.2,0,0.2,6.7,18,1,17,0.056,28,0.643,1,0.667,6.1,20,3,17,0.15,38,0.526,1,0.541,6.2
254,203120,Justin Hamilton,1610612748,MIA,8,4,4,72.0,4,3,0,0.75,11,0.364,0,0.364,6.3,3,2,1,0.667,12,0.25,3,0.333,5.6,7,5,1,0.714,23,0.304,3,0.35,5.9
255,202695,Kawhi Leonard,1610612759,SAS,66,54,12,1923.0,76,50,23,0.658,173,0.439,4,0.45,8.1,336,110,225,0.327,545,0.617,45,0.672,6.4,412,160,248,0.388,718,0.574,49,0.616,6.7
256,2586,Keith Bogans,1610612738,BOS,6,1,5,55.0,0,0,0,0.0,6,0.0,0,0.0,0.0,3,1,2,0.333,6,0.5,0,0.5,6.8,3,1,2,0.333,12,0.25,0,0.25,6.8
257,203482,Kelly Olynyk,1610612738,BOS,70,18,52,1400.0,140,94,41,0.671,335,0.418,16,0.439,6.7,225,66,154,0.293,406,0.554,44,0.622,5.2,365,160,195,0.438,741,0.493,60,0.536,5.7
258,202689,Kemba Walker,1610612766,CHA,72,37,35,2577.0,39,14,26,0.359,191,0.204,10,0.215,12.5,264,42,225,0.159,546,0.484,61,0.544,9.5,303,56,251,0.185,737,0.411,71,0.455,9.9
259,203088,Kendall Marshall,1610612747,LAL,54,14,40,1564.0,15,4,10,0.267,80,0.188,2,0.192,11.9,140,16,126,0.114,267,0.524,13,0.551,11.7,155,20,136,0.129,347,0.447,15,0.467,11.8
260,2570,Kendrick Perkins,1610612760,OKC,62,48,14,1207.0,82,59,22,0.72,222,0.369,6,0.38,5.1,223,60,162,0.269,398,0.56,36,0.616,4.6,305,119,184,0.39,620,0.492,42,0.528,4.7
261,202702,Kenneth Faried,1610612743,DEN,80,36,44,2178.0,238,174,56,0.731,615,0.387,20,0.4,5.2,446,167,277,0.374,757,0.589,63,0.643,4.7,684,341,333,0.499,1372,0.499,83,0.531,4.9
262,203145,Kent Bazemore,1610612747,LAL,67,35,32,911.0,10,4,6,0.4,61,0.164,4,0.175,9.6,107,22,85,0.206,217,0.493,19,0.54,7.2,117,26,91,0.222,278,0.421,23,0.459,7.4
263,203484,Kentavious Caldwell-Pope,1610612765,DET,80,28,52,1583.0,38,16,20,0.421,126,0.302,6,0.317,10.5,118,21,97,0.178,231,0.511,23,0.567,8.3,156,37,117,0.237,357,0.437,29,0.476,8.8
264,2030,Kenyon Martin,1610612752,NYK,32,13,19,633.0,36,24,12,0.667,75,0.48,3,0.5,5.7,98,37,61,0.378,174,0.563,17,0.624,6.1,134,61,73,0.455,249,0.538,20,0.585,6.0
265,201142,Kevin Durant,1610612760,OKC,81,58,23,3122.0,58,26,30,0.448,172,0.337,8,0.354,13.9,540,129,406,0.239,748,0.722,33,0.755,6.9,598,155,436,0.259,920,0.65,41,0.68,7.6
266,708,Kevin Garnett,1610612751,BKN,53,26,27,1090.0,60,31,27,0.517,108,0.556,4,0.577,8.0,295,100,193,0.339,449,0.657,28,0.701,4.5,355,131,220,0.369,557,0.637,32,0.676,5.1
267,201567,Kevin Love,1610612750,MIN,77,39,38,2796.0,224,187,37,0.835,534,0.419,11,0.428,4.7,739,315,416,0.426,1109,0.666,75,0.715,3.9,963,502,453,0.521,1643,0.586,86,0.618,4.1
268,2755,Kevin Martin,1610612750,MIN,68,32,36,2177.0,34,13,20,0.382,183,0.186,7,0.193,11.8,169,23,147,0.136,292,0.579,30,0.645,8.6,203,36,167,0.177,475,0.427,37,0.463,9.2
269,202338,Kevin Seraphin,1610612764,WAS,53,25,28,578.0,53,37,16,0.698,143,0.371,7,0.39,6.8,75,30,45,0.4,168,0.446,20,0.507,5.0,128,67,61,0.523,311,0.412,27,0.451,5.8
270,203114,Khris Middleton,1610612749,MIL,81,15,66,2441.0,60,31,29,0.517,193,0.311,7,0.323,11.8,249,61,187,0.245,456,0.546,31,0.586,7.3,309,92,216,0.298,649,0.476,38,0.506,8.2
271,2550,Kirk Hinrich,1610612741,CHI,73,45,28,2116.0,31,10,24,0.323,142,0.218,7,0.23,17.6,161,20,138,0.124,343,0.469,38,0.528,9.8,192,30,162,0.156,485,0.396,45,0.436,11.3
272,202691,Klay Thompson,1610612744,GSW,80,50,30,2827.0,38,16,18,0.421,167,0.228,10,0.242,13.0,209,37,173,0.177,461,0.453,54,0.514,8.3,247,53,191,0.215,628,0.393,64,0.438,8.9
273,977,Kobe Bryant,1610612747,LAL,6,2,4,177.0,2,1,1,0.5,13,0.154,0,0.154,7.3,24,4,20,0.167,45,0.533,4,0.585,5.7,26,5,21,0.192,58,0.448,4,0.481,5.8
274,201585,Kosta Koufos,1610612763,MEM,80,48,32,1349.0,160,101,60,0.631,361,0.443,18,0.466,5.7,258,109,146,0.422,461,0.56,42,0.616,4.1,418,210,206,0.502,822,0.509,60,0.549,4.7
275,2743,Kris Humphries,1610612738,BOS,69,22,47,1376.0,127,85,38,0.669,356,0.357,11,0.368,7.1,282,113,168,0.401,498,0.566,32,0.605,4.6,409,198,206,0.484,854,0.479,43,0.504,5.4
276,2594,Kyle Korver,1610612737,ATL,70,37,33,2380.0,22,4,17,0.182,109,0.202,2,0.206,19.6,260,70,190,0.269,545,0.477,55,0.531,6.5,282,74,207,0.262,654,0.431,57,0.472,7.5
277,200768,Kyle Lowry,1610612761,TOR,78,44,34,2828.0,87,51,33,0.586,330,0.264,11,0.273,9.8,276,45,233,0.163,595,0.464,53,0.509,8.9,363,96,266,0.264,925,0.392,64,0.422,9.1
278,203124,Kyle O'Quinn,1610612753,ORL,69,20,49,1188.0,100,63,31,0.63,200,0.5,5,0.513,6.5,264,101,159,0.383,468,0.564,35,0.61,4.3,364,164,190,0.451,668,0.545,40,0.58,4.9
279,202713,Kyle Singler,1610612765,DET,82,29,53,2337.0,116,61,54,0.526,360,0.322,14,0.335,9.5,187,67,123,0.358,506,0.37,58,0.417,6.9,303,128,177,0.422,866,0.35,72,0.382,7.9
280,202681,Kyrie Irving,1610612739,CLE,71,28,43,2496.0,52,18,33,0.346,237,0.219,8,0.227,13.9,207,36,175,0.174,438,0.473,36,0.515,10.7,259,54,208,0.208,675,0.384,44,0.41,11.3
281,200746,LaMarcus Aldridge,1610612757,POR,69,46,23,2499.0,166,104,57,0.627,413,0.402,19,0.421,7.1,599,209,391,0.349,946,0.633,70,0.684,5.0,765,313,448,0.409,1359,0.563,89,0.602,5.4
282,202362,Lance Stephenson,1610612754,IND,78,53,25,2752.0,95,47,47,0.495,286,0.332,8,0.342,8.5,463,95,366,0.205,744,0.622,48,0.665,6.3,558,142,413,0.254,1030,0.542,56,0.573,6.7
283,202498,Lance Thomas,1610612740,NOP,5,3,2,42.0,2,2,0,1.0,13,0.154,0,0.154,6.4,5,2,3,0.4,8,0.625,1,0.714,4.2,7,4,3,0.571,21,0.333,1,0.35,4.8
284,202361,Landry Fields,1610612761,TOR,29,13,16,294.0,14,8,5,0.571,47,0.298,3,0.318,7.5,40,7,31,0.175,60,0.667,6,0.741,7.1,54,15,36,0.278,107,0.505,9,0.551,7.2
285,202336,Larry Sanders,1610612749,MIL,22,3,19,563.0,59,42,17,0.712,141,0.418,5,0.434,5.5,102,47,53,0.461,190,0.537,18,0.593,4.8,161,89,70,0.553,331,0.486,23,0.523,5.0
286,202730,Lavoy Allen,1610612754,IND,65,18,47,1071.0,119,76,37,0.639,274,0.434,10,0.451,5.9,192,79,109,0.411,371,0.518,43,0.585,4.8,311,155,146,0.498,645,0.482,53,0.525,5.2
287,2544,LeBron James,1610612748,MIA,77,52,25,2902.0,81,46,33,0.568,221,0.367,4,0.373,8.0,452,108,337,0.239,651,0.694,29,0.727,7.1,533,154,370,0.289,872,0.611,33,0.635,7.3
288,2571,Leandro Barbosa,1610612756,PHX,20,12,8,368.0,5,2,3,0.4,22,0.227,3,0.263,14.6,32,6,24,0.188,48,0.667,3,0.711,9.8,37,8,27,0.216,70,0.529,6,0.578,10.5
289,203485,Lorenzo Brown,1610612755,PHI,26,2,24,224.0,8,2,6,0.25,24,0.333,0,0.333,9.9,20,3,17,0.15,36,0.556,2,0.588,9.5,28,5,23,0.179,60,0.467,2,0.483,9.6
290,200811,Lou Amundson,1610612741,CHI,19,11,8,185.0,28,21,8,0.75,60,0.467,2,0.483,7.1,27,8,18,0.296,60,0.45,6,0.5,7.2,55,29,26,0.527,120,0.458,8,0.491,7.1
291,101150,Lou Williams,1610612737,ATL,59,26,33,1420.0,10,2,7,0.2,74,0.135,6,0.147,14.5,110,15,97,0.136,217,0.507,19,0.556,9.0,120,17,104,0.142,291,0.412,25,0.451,9.4
292,201601,Luc Mbah a Moute,1610612750,MIN,64,31,33,1003.0,56,43,10,0.768,148,0.378,6,0.394,5.4,90,39,51,0.433,183,0.492,19,0.549,6.3,146,82,61,0.562,331,0.441,25,0.477,6.0
293,2449,Luis Scola,1610612754,IND,82,56,26,1399.0,86,53,33,0.616,273,0.315,10,0.327,6.8,305,96,206,0.315,516,0.591,52,0.657,4.4,391,149,239,0.381,789,0.496,62,0.538,5.0
294,202337,Luke Babbitt,1610612740,NOP,27,9,18,473.0,18,11,6,0.611,53,0.34,2,0.353,6.7,70,22,48,0.314,135,0.519,19,0.603,5.1,88,33,54,0.375,188,0.468,21,0.527,5.4
295,2557,Luke Ridnour,1610612766,CHA,60,21,39,1129.0,23,7,15,0.304,58,0.397,3,0.418,13.2,74,13,62,0.176,143,0.517,8,0.548,10.1,97,20,77,0.206,201,0.483,11,0.511,10.8
296,2736,Luol Deng,1610612739,CLE,63,29,34,2213.0,99,55,43,0.556,310,0.319,9,0.329,9.7,262,69,192,0.263,434,0.604,28,0.645,7.5,361,124,235,0.343,744,0.485,37,0.511,8.1
297,203146,Maalik Wayns,1610612746,LAC,2,2,0,9.0,0,0,0,0.0,0,0.0,0,0.0,0.0,2,0,2,0.0,5,0.4,0,0.4,13.0,2,0,2,0.0,5,0.4,0,0.4,13.0
298,202952,Malcolm Thomas,1610612762,UTA,8,2,6,63.0,5,2,3,0.4,8,0.625,0,0.625,4.6,16,3,13,0.188,27,0.593,1,0.615,6.3,21,5,16,0.238,35,0.6,1,0.618,5.9
299,202412,Manny Harris,1610612747,LAL,9,2,7,180.0,7,4,3,0.571,31,0.226,0,0.226,9.6,27,6,21,0.222,47,0.574,5,0.643,7.4,34,10,24,0.294,78,0.436,5,0.466,7.8
300,1938,Manu Ginobili,1610612759,SAS,68,52,16,1550.0,30,17,13,0.567,121,0.248,5,0.259,8.6,172,41,131,0.238,335,0.513,27,0.558,7.0,202,58,144,0.287,456,0.443,32,0.476,7.2
301,202705,MarShon Brooks,1610612747,LAL,35,13,22,317.0,10,8,2,0.8,46,0.217,1,0.222,4.6,44,9,35,0.205,63,0.698,5,0.759,8.1,54,17,37,0.315,109,0.495,6,0.524,7.4
302,201188,Marc Gasol,1610612763,MEM,59,40,19,1970.0,84,48,32,0.571,207,0.406,6,0.418,7.7,340,152,186,0.447,593,0.573,57,0.634,5.0,424,200,218,0.472,800,0.53,63,0.575,5.5
303,101162,Marcin Gortat,1610612764,WAS,80,44,36,2620.0,201,116,80,0.577,547,0.367,14,0.377,6.1,556,202,349,0.363,1017,0.547,116,0.617,4.3,757,318,429,0.42,1564,0.484,130,0.528,4.8
304,201158,Marco Belinelli,1610612759,SAS,80,61,19,2016.0,18,6,12,0.333,103,0.175,8,0.189,10.8,208,31,176,0.149,416,0.5,33,0.543,7.2,226,37,188,0.164,519,0.435,41,0.473,7.5
305,202694,Marcus Morris,1610612756,PHX,82,48,34,1800.0,84,48,36,0.571,205,0.41,8,0.426,8.2,235,74,158,0.315,435,0.54,44,0.601,5.3,319,122,194,0.382,640,0.498,52,0.543,6.0
306,201977,Marcus Thornton,1610612751,BKN,71,33,38,1711.0,57,24,32,0.421,178,0.32,13,0.345,10.1,141,21,121,0.149,281,0.502,31,0.564,8.9,198,45,153,0.227,459,0.431,44,0.477,9.3
307,201596,Mario Chalmers,1610612748,MIA,73,49,24,2178.0,41,17,24,0.415,146,0.281,7,0.295,13.6,173,20,152,0.116,406,0.426,42,0.475,9.8,214,37,176,0.173,552,0.388,49,0.425,10.5
308,202693,Markieff Morris,1610612756,PHX,81,47,34,2153.0,139,88,48,0.633,333,0.417,18,0.441,6.3,346,120,215,0.347,593,0.583,47,0.634,5.6,485,208,263,0.429,926,0.524,65,0.563,5.8
309,203104,Marquis Teague,1610612751,BKN,40,20,20,442.0,1,0,1,0.0,50,0.02,5,0.022,21.8,39,4,34,0.103,67,0.582,1,0.591,10.4,40,4,35,0.1,117,0.342,6,0.36,10.7
310,201578,Marreese Speights,1610612744,GSW,78,47,31,971.0,100,68,25,0.68,231,0.433,4,0.441,5.5,187,71,116,0.38,335,0.558,36,0.625,4.4,287,139,141,0.484,566,0.507,40,0.546,4.7
311,101110,Martell Webster,1610612764,WAS,77,42,35,2127.0,37,14,22,0.378,109,0.339,11,0.378,13.8,181,52,131,0.287,351,0.516,30,0.564,6.6,218,66,153,0.303,460,0.474,41,0.52,7.8
312,101107,Marvin Williams,1610612762,UTA,66,24,42,1674.0,82,41,40,0.5,179,0.458,3,0.466,8.2,252,81,168,0.321,436,0.578,38,0.633,5.8,334,122,208,0.365,615,0.543,41,0.582,6.3
313,203486,Mason Plumlee,1610612751,BKN,69,36,33,1272.0,99,62,34,0.626,260,0.381,6,0.39,5.8,209,75,130,0.359,391,0.535,33,0.584,4.5,308,137,164,0.445,651,0.473,39,0.503,4.9
314,2440,Matt Barnes,1610612746,LAC,63,45,18,1735.0,60,25,32,0.417,171,0.351,6,0.364,10.2,232,62,170,0.267,428,0.542,39,0.596,6.3,292,87,202,0.298,599,0.487,45,0.527,7.1
315,2588,Matt Bonner,1610612759,SAS,61,43,18,690.0,16,8,9,0.5,51,0.314,0,0.314,9.4,114,39,76,0.342,223,0.511,23,0.57,6.0,130,47,85,0.362,274,0.474,23,0.518,6.4
316,203521,Matthew Dellavedova,1610612739,CLE,72,29,43,1271.0,29,7,21,0.241,107,0.271,3,0.279,13.9,94,13,81,0.138,231,0.407,28,0.463,10.1,123,20,102,0.163,338,0.364,31,0.401,11.1
317,203090,Maurice Harkless,1610612753,ORL,80,22,58,1950.0,69,39,29,0.565,187,0.369,12,0.394,7.7,195,44,152,0.226,356,0.548,35,0.607,7.4,264,83,181,0.314,543,0.486,47,0.532,7.5
318,2408,Melvin Ely,1610612740,NOP,2,2,0,27.0,0,0,0,0.0,0,0.0,0,0.0,0.0,1,0,1,0.0,4,0.25,0,0.25,12.8,1,0,1,0.0,4,0.25,0,0.25,12.8
319,1897,Metta World Peace,1610612752,NYK,29,10,19,388.0,18,10,7,0.556,58,0.31,2,0.321,6.2,41,17,23,0.415,75,0.547,6,0.594,5.8,59,27,30,0.458,133,0.444,8,0.472,5.9
320,203086,Meyers Leonard,1610612757,POR,40,20,20,355.0,26,13,13,0.5,79,0.329,2,0.338,7.2,85,27,58,0.318,142,0.599,13,0.659,4.4,111,40,71,0.36,221,0.502,15,0.539,5.1
321,201563,Michael Beasley,1610612748,MIA,55,36,19,831.0,31,21,10,0.677,83,0.373,1,0.378,7.6,141,39,99,0.277,249,0.566,20,0.616,5.2,172,60,109,0.349,332,0.518,21,0.553,5.6
322,203487,Michael Carter-Williams,1610612755,PHI,70,18,52,2414.0,101,60,36,0.594,401,0.252,20,0.265,6.3,336,86,247,0.256,591,0.569,38,0.608,6.8,437,146,283,0.334,992,0.441,58,0.468,6.7
323,203077,Michael Kidd-Gilchrist,1610612766,CHA,61,34,27,1472.0,106,71,35,0.67,284,0.373,9,0.385,7.8,206,67,137,0.325,395,0.522,36,0.574,6.0,312,138,172,0.442,679,0.459,45,0.492,6.6
324,201144,Mike Conley,1610612763,MEM,73,46,27,2446.0,41,16,25,0.39,174,0.236,12,0.253,13.9,172,26,146,0.151,355,0.485,41,0.548,9.2,213,42,171,0.197,529,0.403,53,0.447,10.2
325,2399,Mike Dunleavy,1610612741,CHI,82,48,34,2584.0,46,29,18,0.63,209,0.22,4,0.224,8.0,299,80,219,0.268,636,0.47,70,0.528,6.7,345,109,237,0.316,845,0.408,74,0.447,6.9
326,200839,Mike Harris,1610612762,UTA,20,1,19,225.0,15,12,3,0.8,48,0.313,3,0.333,6.8,18,6,12,0.333,61,0.295,11,0.36,6.7,33,18,15,0.545,109,0.303,14,0.347,6.7
327,2229,Mike James,1610612741,CHI,11,3,8,77.0,0,0,0,0.0,3,0.0,0,0.0,0.0,7,1,6,0.143,8,0.875,0,0.875,8.6,7,1,6,0.143,11,0.636,0,0.636,8.6
328,2034,Mike Miller,1610612763,MEM,82,50,32,1706.0,30,11,20,0.367,110,0.273,4,0.283,12.2,177,35,141,0.198,305,0.58,26,0.634,6.0,207,46,161,0.222,415,0.499,30,0.538,6.9
329,203488,Mike Muscala,1610612737,ATL,20,10,10,215.0,17,12,5,0.706,55,0.309,1,0.315,5.9,35,11,24,0.314,66,0.53,7,0.593,4.6,52,23,29,0.442,121,0.43,8,0.46,5.0
330,203118,Mike Scott,1610612737,ATL,79,36,43,1454.0,60,37,23,0.617,227,0.264,5,0.27,5.9,220,77,141,0.35,357,0.616,28,0.669,5.9,280,114,164,0.407,584,0.479,33,0.508,6.0
331,203101,Miles Plumlee,1610612756,PHX,80,47,33,1964.0,198,128,67,0.646,457,0.433,7,0.44,6.3,428,179,247,0.418,768,0.557,74,0.617,3.9,626,307,314,0.49,1225,0.511,81,0.547,4.7
332,203545,Miroslav Raduljica,1610612749,MIL,48,7,41,465.0,54,37,16,0.685,113,0.478,10,0.524,5.7,54,26,29,0.481,135,0.4,10,0.432,5.7,108,63,45,0.583,248,0.435,20,0.474,5.7
333,203141,Mirza Teletovic,1610612751,BKN,71,40,31,1373.0,60,30,25,0.5,141,0.426,3,0.435,8.9,201,72,128,0.358,371,0.542,28,0.586,5.9,261,102,153,0.391,512,0.51,31,0.543,6.6
334,2590,Mo Williams,1610612757,POR,74,49,25,1833.0,42,11,31,0.262,134,0.313,4,0.323,14.8,111,13,96,0.117,283,0.392,32,0.442,9.7,153,24,127,0.157,417,0.367,36,0.402,11.2
335,101145,Monta Ellis,1610612742,DAL,82,49,33,3023.0,38,17,21,0.447,201,0.189,13,0.202,11.1,257,49,206,0.191,461,0.557,42,0.613,9.9,295,66,227,0.224,662,0.446,55,0.486,10.1
336,201203,Mustafa Shakur,1610612760,OKC,3,2,1,11.0,0,0,0,0.0,0,0.0,0,0.0,0.0,0,0,0,0.0,0,0.0,0,0.0,0.0,0,0,0,0.0,0,0.0,0,0.0,0.0
337,201986,Nando De Colo,1610612761,TOR,47,36,11,494.0,14,6,7,0.429,46,0.304,2,0.318,12.8,59,12,47,0.203,120,0.492,10,0.536,6.3,73,18,54,0.247,166,0.44,12,0.474,7.4
338,101126,Nate Robinson,1610612743,DEN,44,22,22,866.0,21,4,15,0.19,74,0.284,5,0.304,8.8,60,6,55,0.1,131,0.458,8,0.488,10.6,81,10,70,0.123,205,0.395,13,0.422,10.2
339,203489,Nate Wolters,1610612749,MIL,57,10,47,1273.0,33,15,18,0.455,126,0.262,3,0.268,11.4,112,18,94,0.161,238,0.471,26,0.528,8.3,145,33,112,0.228,364,0.398,29,0.433,9.0
340,1737,Nazr Mohammed,1610612741,CHI,80,47,33,562.0,66,42,20,0.636,139,0.475,3,0.485,5.6,109,43,62,0.394,182,0.599,14,0.649,5.4,175,85,82,0.486,321,0.545,17,0.576,5.5
341,203517,Nemanja Nedovic,1610612744,GSW,23,16,7,134.0,3,0,3,0.0,10,0.3,0,0.3,22.7,11,1,10,0.091,23,0.478,3,0.55,11.4,14,1,13,0.071,33,0.424,3,0.467,13.8
342,2403,Nene,1610612764,WAS,53,30,23,1560.0,65,39,20,0.6,248,0.262,12,0.275,7.7,229,81,148,0.354,451,0.508,43,0.561,6.2,294,120,168,0.408,699,0.421,55,0.457,6.5
343,201979,Nick Calathes,1610612763,MEM,71,42,29,1173.0,23,7,16,0.304,96,0.24,5,0.253,11.4,114,28,87,0.246,252,0.452,20,0.491,10.3,137,35,103,0.255,348,0.394,25,0.424,10.5
344,2555,Nick Collison,1610612760,OKC,81,58,23,1353.0,116,74,40,0.638,260,0.446,6,0.457,5.9,177,85,89,0.48,396,0.447,54,0.518,5.3,293,159,129,0.543,656,0.447,60,0.492,5.6
345,201156,Nick Young,1610612747,LAL,64,21,43,1809.0,29,7,22,0.241,123,0.236,4,0.244,12.6,137,23,115,0.168,284,0.482,17,0.513,9.0,166,30,137,0.181,407,0.408,21,0.43,9.6
346,201587,Nicolas Batum,1610612757,POR,82,54,28,2956.0,116,64,54,0.552,354,0.328,13,0.34,9.2,495,119,371,0.24,837,0.591,62,0.639,5.9,611,183,425,0.3,1191,0.513,75,0.547,6.5
347,201593,Nikola Pekovic,1610612750,MIN,54,27,27,1663.0,206,147,52,0.714,498,0.414,11,0.423,4.5,262,108,153,0.412,465,0.563,40,0.616,5.2,468,255,205,0.545,963,0.486,51,0.513,4.9
348,202696,Nikola Vucevic,1610612753,ORL,57,19,38,1812.0,185,132,50,0.714,391,0.473,7,0.482,5.5,441,155,283,0.351,709,0.622,52,0.671,4.1,626,287,333,0.458,1100,0.569,59,0.601,4.5
349,202708,Norris Cole,1610612748,MIA,82,54,28,2014.0,17,4,12,0.235,93,0.183,5,0.193,17.1,143,21,124,0.147,333,0.429,32,0.475,9.5,160,25,136,0.156,426,0.376,37,0.411,10.3
350,201564,O.J. Mayo,1610612749,MIL,51,10,41,1314.0,23,6,15,0.261,101,0.228,3,0.235,16.1,95,19,77,0.2,201,0.473,8,0.492,9.8,118,25,92,0.212,302,0.391,11,0.405,11.0
351,203136,Ognjen Kuzmic,1610612744,GSW,21,16,5,92.0,10,8,2,0.8,25,0.4,1,0.417,4.4,11,5,6,0.455,27,0.407,3,0.458,3.7,21,13,8,0.619,52,0.404,4,0.438,4.0
352,201600,Omer Asik,1610612745,HOU,48,32,16,968.0,101,86,14,0.851,246,0.411,5,0.419,3.8,277,131,143,0.473,429,0.646,33,0.699,4.2,378,217,157,0.574,675,0.56,38,0.593,4.1
353,201956,Omri Casspi,1610612745,HOU,71,46,25,1283.0,55,27,28,0.491,186,0.296,5,0.304,7.9,205,58,145,0.283,386,0.531,34,0.582,5.8,260,85,173,0.327,572,0.455,39,0.488,6.2
354,203111,Orlando Johnson,1610612758,SAC,45,34,11,392.0,9,7,2,0.778,44,0.205,2,0.214,7.7,46,10,36,0.217,94,0.489,13,0.568,7.2,55,17,38,0.309,138,0.399,15,0.447,7.3
355,201785,Othyus Jeffers,1610612750,MIN,6,2,4,47.0,1,1,0,1.0,6,0.167,0,0.167,1.7,8,1,7,0.125,11,0.727,1,0.8,5.7,9,2,7,0.222,17,0.529,1,0.563,5.3
356,203490,Otto Porter Jr.,1610612764,WAS,37,20,17,319.0,21,11,10,0.524,58,0.362,4,0.389,9.1,36,7,26,0.194,61,0.59,9,0.692,6.2,57,18,36,0.316,119,0.479,13,0.538,7.3
357,200782,PJ Tucker,1610612756,PHX,81,48,33,2490.0,161,98,56,0.609,435,0.37,12,0.381,7.5,368,79,282,0.215,532,0.692,38,0.745,6.9,529,177,338,0.335,967,0.547,50,0.577,7.1
358,203143,Pablo Prigioni,1610612752,NYK,66,29,37,1283.0,36,14,21,0.389,110,0.327,6,0.346,12.5,93,7,87,0.075,207,0.449,7,0.465,10.3,129,21,108,0.163,317,0.407,13,0.424,10.9
359,201976,Patrick Beverley,1610612745,HOU,56,39,17,1751.0,72,31,41,0.431,199,0.362,8,0.377,10.5,124,18,105,0.145,264,0.47,32,0.534,10.4,196,49,146,0.25,463,0.423,40,0.463,10.5
360,202335,Patrick Patterson,1610612761,TOR,64,37,27,1506.0,114,67,45,0.588,244,0.467,9,0.485,6.9,221,92,126,0.416,403,0.548,30,0.592,5.0,335,159,171,0.475,647,0.518,39,0.551,5.7
361,201988,Patty Mills,1610612759,SAS,81,62,19,1527.0,34,7,25,0.206,118,0.288,4,0.298,16.3,135,20,117,0.148,256,0.527,18,0.567,10.1,169,27,142,0.16,374,0.452,22,0.48,11.3
362,2200,Pau Gasol,1610612747,LAL,60,21,39,1884.0,124,72,44,0.581,300,0.413,8,0.425,8.1,456,168,285,0.368,727,0.627,47,0.671,4.5,580,240,329,0.414,1027,0.565,55,0.597,5.2
363,202331,Paul George,1610612754,IND,80,54,26,2898.0,64,34,30,0.531,305,0.21,9,0.216,12.9,478,89,384,0.186,751,0.636,53,0.685,6.1,542,123,414,0.227,1056,0.513,62,0.545,6.9
364,200794,Paul Millsap,1610612737,ATL,73,36,37,2453.0,152,100,49,0.658,421,0.361,13,0.373,6.7,472,181,287,0.383,855,0.552,77,0.607,5.0,624,281,336,0.45,1276,0.489,90,0.526,5.5
365,1718,Paul Pierce,1610612751,BKN,74,41,33,2071.0,26,11,13,0.423,122,0.213,5,0.222,11.8,319,109,207,0.342,569,0.561,52,0.617,6.6,345,120,220,0.348,691,0.499,57,0.544,6.9
366,203544,Pero Antic,1610612737,ATL,49,23,26,902.0,57,33,22,0.579,137,0.416,4,0.429,5.4,147,60,87,0.408,275,0.535,24,0.586,5.2,204,93,109,0.456,412,0.495,28,0.531,5.2
367,203103,Perry Jones III,1610612760,OKC,62,45,17,764.0,28,14,14,0.5,85,0.329,4,0.346,9.8,86,24,60,0.279,161,0.534,20,0.61,6.5,114,38,74,0.333,246,0.463,24,0.514,7.3
368,203491,Peyton Siva,1610612765,DET,24,9,15,224.0,2,0,2,0.0,17,0.118,1,0.125,15.3,12,2,10,0.167,32,0.375,3,0.414,8.5,14,2,12,0.143,49,0.286,4,0.311,9.4
369,203515,Phil Pressey,1610612738,BOS,75,23,52,1132.0,20,6,14,0.3,91,0.22,4,0.23,11.9,85,6,80,0.071,194,0.438,16,0.478,10.4,105,12,94,0.114,285,0.368,20,0.396,10.7
370,203112,Quincy Acy,1610612758,SAC,63,22,41,848.0,72,40,30,0.556,202,0.356,9,0.373,8.4,144,51,89,0.354,261,0.552,28,0.618,4.4,216,91,119,0.421,463,0.467,37,0.507,5.7
371,203113,Quincy Miller,1610612743,DEN,52,21,31,789.0,36,19,13,0.528,119,0.303,3,0.31,8.8,111,30,84,0.27,216,0.514,25,0.581,6.2,147,49,97,0.333,335,0.439,28,0.479,6.8
372,202347,Quincy Pondexter,1610612763,MEM,15,7,8,270.0,10,6,5,0.6,34,0.294,2,0.313,8.5,16,2,14,0.125,31,0.516,4,0.593,10.5,26,8,19,0.308,65,0.4,6,0.441,9.9
373,200765,Rajon Rondo,1610612738,BOS,30,6,24,998.0,22,9,13,0.409,109,0.202,5,0.212,11.7,142,19,125,0.134,267,0.532,25,0.587,6.8,164,28,138,0.171,376,0.436,30,0.474,7.5
374,201196,Ramon Sessions,1610612749,MIL,83,30,53,2214.0,38,12,28,0.316,183,0.208,8,0.217,12.8,165,15,148,0.091,286,0.577,20,0.62,10.9,203,27,176,0.133,469,0.433,28,0.46,11.2
375,200751,Randy Foye,1610612743,DEN,81,36,45,2485.0,36,13,21,0.361,160,0.225,7,0.235,19.3,196,30,166,0.153,405,0.484,36,0.531,10.1,232,43,187,0.185,565,0.411,43,0.444,11.4
376,1740,Rashard Lewis,1610612748,MIA,60,41,19,971.0,24,11,14,0.458,71,0.338,2,0.348,9.8,86,27,58,0.314,195,0.441,19,0.489,5.7,110,38,72,0.345,266,0.414,21,0.449,6.6
377,2446,Rasual Butler,1610612754,IND,50,30,20,378.0,6,5,1,0.833,32,0.188,0,0.188,8.0,35,7,26,0.2,67,0.522,7,0.583,6.9,41,12,27,0.293,99,0.414,7,0.446,7.0
378,951,Ray Allen,1610612748,MIA,73,47,26,1936.0,23,10,14,0.435,108,0.213,5,0.223,13.2,182,38,144,0.209,336,0.542,19,0.574,7.6,205,48,158,0.234,444,0.462,24,0.488,8.3
379,203492,Ray McCallum,1610612758,SAC,45,16,29,897.0,18,6,11,0.333,73,0.247,3,0.257,14.4,61,9,54,0.148,134,0.455,14,0.508,10.8,79,15,65,0.19,207,0.382,17,0.416,11.6
380,101109,Raymond Felton,1610612752,NYK,65,31,34,2017.0,54,23,31,0.426,194,0.278,13,0.298,11.5,143,29,113,0.203,332,0.431,31,0.475,10.4,197,52,144,0.264,526,0.375,44,0.409,10.7
381,203493,Reggie Bullock,1610612746,LAC,43,30,13,396.0,11,5,6,0.455,25,0.44,3,0.5,12.7,43,12,29,0.279,88,0.489,7,0.531,7.3,54,17,35,0.315,113,0.478,10,0.524,8.4
382,2501,Reggie Evans,1610612758,SAC,54,18,36,899.0,115,86,26,0.748,328,0.351,11,0.363,6.0,219,74,143,0.338,352,0.622,28,0.676,4.3,334,160,169,0.479,680,0.491,39,0.521,4.8
383,202704,Reggie Jackson,1610612760,OKC,80,57,23,2277.0,43,16,28,0.372,172,0.25,6,0.259,13.4,270,53,216,0.196,498,0.542,51,0.604,7.6,313,69,244,0.22,670,0.467,57,0.511,8.4
384,202130,Reggie Williams,1610612760,OKC,3,3,0,17.0,0,0,0,0.0,0,0.0,0,0.0,0.0,0,0,0,0.0,1,0.0,0,0.0,0.0,0,0,0,0.0,1,0.0,0,0.0,0.0
385,2210,Richard Jefferson,1610612762,UTA,82,25,57,2213.0,18,6,15,0.333,133,0.135,4,0.14,14.2,201,32,166,0.159,391,0.514,37,0.568,7.4,219,38,181,0.174,524,0.418,41,0.453,8.1
386,203495,Ricky Ledo,1610612742,DAL,11,5,6,33.0,0,0,0,0.0,3,0.0,0,0.0,0.0,2,2,0,1.0,4,0.5,1,0.667,1.2,2,2,0,1.0,7,0.286,1,0.333,1.2
387,201937,Ricky Rubio,1610612750,MIN,82,40,42,2638.0,61,21,38,0.344,318,0.192,10,0.198,14.3,281,61,221,0.217,505,0.556,40,0.604,9.0,342,82,259,0.24,823,0.416,50,0.442,9.9
388,203133,Robbie Hummel,1610612750,MIN,53,26,27,655.0,35,14,20,0.4,84,0.417,2,0.427,11.2,97,29,67,0.299,178,0.545,19,0.61,4.9,132,43,87,0.326,262,0.504,21,0.548,6.5
389,203496,Robert Covington,1610612745,HOU,7,4,3,34.0,2,1,1,0.5,3,0.667,0,0.667,3.3,3,1,2,0.333,11,0.273,2,0.333,4.8,5,2,3,0.4,14,0.357,2,0.417,4.2
390,203135,Robert Sacre,1610612747,LAL,65,20,45,1089.0,82,40,43,0.488,207,0.396,8,0.412,5.4,172,70,101,0.407,382,0.45,34,0.494,4.9,254,110,144,0.433,589,0.431,42,0.464,5.1
391,201577,Robin Lopez,1610612757,POR,82,54,28,2604.0,326,234,83,0.718,811,0.402,24,0.414,5.0,374,162,204,0.433,839,0.446,94,0.502,5.3,700,396,287,0.566,1650,0.424,118,0.457,5.2
392,201155,Rodney Stuckey,1610612765,DET,73,27,46,1950.0,39,18,21,0.462,161,0.242,4,0.248,12.5,130,29,102,0.223,260,0.5,22,0.546,9.1,169,47,123,0.278,421,0.401,26,0.428,9.9
393,2427,Roger Mason Jr.,1610612748,MIA,25,18,7,260.0,1,0,1,0.0,6,0.167,1,0.2,29.1,21,5,16,0.238,37,0.568,5,0.656,11.4,22,5,17,0.227,43,0.512,6,0.595,12.2
394,200758,Ronnie Brewer,1610612741,CHI,24,17,7,160.0,2,0,2,0.0,11,0.182,0,0.182,17.0,12,5,7,0.417,30,0.4,3,0.444,5.8,14,5,9,0.357,41,0.341,3,0.368,7.4
395,101179,Ronnie Price,1610612753,ORL,31,9,22,377.0,8,4,5,0.5,31,0.258,1,0.267,13.4,35,5,31,0.143,73,0.479,2,0.493,10.4,43,9,36,0.209,104,0.413,3,0.426,11.0
396,101142,Ronny Turiaf,1610612750,MIN,31,16,15,606.0,55,40,14,0.727,117,0.47,3,0.482,6.1,119,49,64,0.412,223,0.534,31,0.62,3.9,174,89,78,0.511,340,0.512,34,0.569,4.6
397,201579,Roy Hibbert,1610612754,IND,81,55,26,2409.0,202,144,52,0.713,569,0.355,9,0.361,5.0,336,140,191,0.417,760,0.442,82,0.496,5.2,538,284,243,0.528,1329,0.405,91,0.435,5.1
398,2767,Royal Ivey,1610612760,OKC,2,2,0,5.0,0,0,0,0.0,0,0.0,0,0.0,0.0,1,0,1,0.0,1,1.0,0,1.0,17.8,1,0,1,0.0,1,1.0,0,1.0,17.8
399,203091,Royce White,1610612758,SAC,3,1,2,9.0,0,0,0,0.0,0,0.0,0,0.0,0.0,0,0,0,0.0,1,0.0,1,0.0,0.0,0,0,0,0.0,1,0.0,1,0.0,0.0
400,200752,Rudy Gay,1610612758,SAC,72,26,46,2495.0,111,64,41,0.577,371,0.299,10,0.307,8.1,311,84,225,0.27,538,0.578,52,0.64,6.5,422,148,266,0.351,909,0.464,62,0.498,6.9
401,203497,Rudy Gobert,1610612762,UTA,45,7,38,434.0,51,35,16,0.686,122,0.418,5,0.436,5.8,104,39,64,0.375,190,0.547,14,0.591,4.8,155,74,80,0.477,312,0.497,19,0.529,5.1
402,201566,Russell Westbrook,1610612760,OKC,46,34,12,1412.0,55,21,35,0.382,190,0.289,5,0.297,9.8,208,47,161,0.226,337,0.617,21,0.658,8.2,263,68,196,0.259,527,0.499,26,0.525,8.6
403,201583,Ryan Anderson,1610612740,NOP,22,12,10,795.0,66,42,19,0.636,157,0.42,10,0.449,4.9,76,36,41,0.474,183,0.415,23,0.475,5.3,142,78,60,0.549,340,0.418,33,0.463,5.1
404,101155,Ryan Gomes,1610612760,OKC,5,3,2,34.0,0,0,0,0.0,2,0.0,0,0.0,0.0,4,1,3,0.25,6,0.667,0,0.667,6.8,4,1,3,0.25,8,0.5,0,0.5,6.8
405,200797,Ryan Hollins,1610612746,LAC,61,43,18,482.0,31,22,9,0.71,116,0.267,3,0.274,5.7,59,25,36,0.424,154,0.383,16,0.428,5.6,90,47,45,0.522,270,0.333,19,0.359,5.6
406,203527,Ryan Kelly,1610612747,LAL,59,15,44,1312.0,42,19,21,0.452,98,0.429,3,0.442,10.3,177,61,117,0.345,331,0.535,28,0.584,5.7,219,80,138,0.365,429,0.51,31,0.55,6.6
407,2223,Samuel Dalembert,1610612742,DAL,80,48,32,1614.0,200,140,61,0.7,455,0.44,10,0.449,5.0,341,139,200,0.408,622,0.548,66,0.613,4.3,541,279,261,0.516,1077,0.502,76,0.54,4.6
408,2756,Sasha Vujacic,1610612746,LAC,2,1,1,10.0,0,0,0,0.0,1,0.0,0,0.0,0.0,3,0,3,0.0,4,0.75,0,0.75,7.2,3,0,3,0.0,5,0.6,0,0.6,7.2
409,203816,Scotty Hopson,1610612739,CLE,2,2,0,7.0,0,0,0,0.0,1,0.0,0,0.0,0.0,0,0,0,0.0,0,0.0,0,0.0,0.0,0,0,0,0.0,1,0.0,0,0.0,0.0
410,201586,Serge Ibaka,1610612760,OKC,81,59,22,2666.0,224,148,72,0.661,484,0.463,16,0.479,5.9,485,212,272,0.437,940,0.516,107,0.582,4.2,709,360,344,0.508,1424,0.498,123,0.545,4.7
411,203508,Sergey Karasev,1610612739,CLE,22,7,15,156.0,0,0,0,0.0,10,0.0,1,0.0,0.0,16,0,16,0.0,37,0.432,3,0.471,7.1,16,0,16,0.0,47,0.34,4,0.372,7.1
412,203552,Seth Curry,1610612739,CLE,2,1,1,13.0,0,0,0,0.0,0,0.0,0,0.0,0.0,1,1,0,1.0,2,0.5,0,0.5,2.2,1,1,0,1.0,2,0.5,0,0.5,2.2
413,203498,Shabazz Muhammad,1610612750,MIN,37,21,16,290.0,24,18,6,0.75,67,0.358,2,0.369,5.4,29,10,20,0.345,61,0.475,5,0.518,5.6,53,28,26,0.528,128,0.414,7,0.438,5.5
414,2203,Shane Battier,1610612748,MIA,73,49,24,1468.0,34,17,15,0.5,92,0.37,2,0.378,8.1,104,40,63,0.385,370,0.281,49,0.324,6.7,138,57,78,0.413,462,0.299,51,0.336,7.2
415,202197,Shane Edwards,1610612739,CLE,2,0,2,12.0,1,1,0,1.0,2,0.5,0,0.5,3.9,1,1,0,1.0,2,0.5,0,0.5,2.8,2,2,0,1.0,4,0.5,0,0.5,3.4
416,203499,Shane Larkin,1610612742,DAL,48,26,22,489.0,11,2,8,0.182,31,0.355,1,0.367,15.8,31,6,25,0.194,75,0.413,6,0.449,9.7,42,8,33,0.19,106,0.396,7,0.424,11.2
417,200769,Shannon Brown,1610612752,NYK,29,19,10,251.0,7,0,7,0.0,21,0.333,0,0.333,15.1,21,1,20,0.048,42,0.5,1,0.512,8.7,28,1,27,0.036,63,0.444,1,0.452,10.8
418,2733,Shaun Livingston,1610612751,BKN,75,41,34,1952.0,65,26,41,0.4,186,0.349,8,0.365,10.1,176,43,137,0.244,352,0.5,22,0.533,8.3,241,69,178,0.286,538,0.448,30,0.474,8.8
419,101183,Shavlik Randolph,1610612756,PHX,14,8,6,95.0,7,3,4,0.429,32,0.219,3,0.241,4.3,18,7,10,0.389,41,0.439,8,0.545,3.3,25,10,14,0.4,73,0.342,11,0.403,3.6
420,1890,Shawn Marion,1610612742,DAL,76,44,32,2409.0,132,69,62,0.523,336,0.393,12,0.407,8.4,365,98,260,0.268,546,0.668,35,0.714,6.9,497,167,322,0.336,882,0.563,47,0.595,7.3
421,200761,Shawne Williams,1610612747,LAL,36,14,22,751.0,25,12,14,0.48,80,0.313,1,0.316,10.7,142,51,89,0.359,259,0.548,14,0.58,5.1,167,63,103,0.377,339,0.493,15,0.515,6.0
422,202714,Shelvin Mack,1610612737,ATL,72,33,39,1468.0,21,10,12,0.476,109,0.193,5,0.202,12.2,137,28,108,0.204,281,0.488,27,0.539,7.7,158,38,120,0.241,390,0.405,32,0.441,8.3
423,203524,Solomon Hill,1610612754,IND,28,17,11,226.0,9,7,2,0.778,34,0.265,1,0.273,6.8,32,9,23,0.281,46,0.696,2,0.727,6.6,41,16,25,0.39,80,0.513,3,0.532,6.6
424,200780,Solomon Jones,1610612753,ORL,11,2,9,85.0,8,5,3,0.625,18,0.444,1,0.471,8.7,8,3,5,0.375,18,0.444,2,0.5,5.4,16,8,8,0.5,36,0.444,3,0.485,7.1
425,201150,Spencer Hawes,1610612739,CLE,80,26,54,2470.0,131,77,53,0.588,375,0.349,12,0.361,7.1,529,211,312,0.399,969,0.546,88,0.6,4.5,660,288,365,0.436,1344,0.491,100,0.531,4.9
426,201939,Stephen Curry,1610612744,GSW,77,49,28,2806.0,46,14,37,0.304,206,0.223,9,0.234,16.5,286,53,237,0.185,539,0.531,39,0.572,9.2,332,67,274,0.202,745,0.446,48,0.476,10.4
427,1536,Stephen Jackson,1610612746,LAC,9,6,3,107.0,2,2,0,1.0,6,0.333,0,0.333,10.3,8,4,4,0.5,22,0.364,3,0.421,6.7,10,6,4,0.6,28,0.357,3,0.4,7.4
428,2581,Steve Blake,1610612744,GSW,55,31,24,1498.0,13,6,7,0.462,55,0.236,3,0.25,18.9,146,21,125,0.144,301,0.485,29,0.537,10.5,159,27,132,0.17,356,0.447,32,0.491,11.2
429,959,Steve Nash,1610612747,LAL,15,4,11,313.0,4,0,5,0.0,18,0.222,1,0.235,11.4,25,3,22,0.12,54,0.463,3,0.49,10.7,29,3,27,0.103,72,0.403,4,0.426,11.2
430,200779,Steve Novak,1610612761,TOR,54,28,26,540.0,8,2,6,0.25,15,0.533,0,0.533,9.9,50,21,29,0.42,116,0.431,3,0.442,7.3,58,23,35,0.397,131,0.443,3,0.453,7.9
431,203500,Steven Adams,1610612760,OKC,81,59,22,1197.0,142,107,34,0.754,370,0.384,11,0.396,4.4,190,85,105,0.447,401,0.474,52,0.544,4.4,332,192,139,0.578,771,0.431,63,0.469,4.4
432,201959,Taj Gibson,1610612741,CHI,82,48,34,2351.0,200,116,77,0.58,505,0.396,19,0.412,6.9,358,143,214,0.399,701,0.511,73,0.57,5.6,558,259,291,0.464,1206,0.463,92,0.501,6.1
433,2419,Tayshaun Prince,1610612763,MEM,76,46,30,1948.0,32,15,17,0.469,150,0.213,1,0.215,9.7,202,64,137,0.317,346,0.584,24,0.627,7.2,234,79,154,0.338,496,0.472,25,0.497,7.6
434,203093,Terrence Jones,1610612745,HOU,76,51,25,2078.0,162,91,64,0.562,387,0.419,10,0.43,6.9,366,133,232,0.363,624,0.587,48,0.635,5.7,528,224,296,0.424,1011,0.522,58,0.554,6.0
435,203082,Terrence Ross,1610612761,TOR,80,46,34,2137.0,43,21,22,0.488,133,0.323,5,0.336,13.7,204,34,168,0.167,373,0.547,22,0.581,6.7,247,55,190,0.223,506,0.488,27,0.516,7.9
436,200757,Thabo Sefolosha,1610612760,OKC,61,44,17,1584.0,50,23,25,0.46,157,0.318,9,0.338,10.1,170,38,131,0.224,297,0.572,30,0.637,9.2,220,61,156,0.277,454,0.485,39,0.53,9.4
437,201152,Thaddeus Young,1610612755,PHI,79,18,61,2718.0,166,95,63,0.572,452,0.367,18,0.382,6.5,310,107,204,0.345,600,0.517,43,0.557,7.0,476,202,267,0.424,1052,0.452,61,0.48,6.9
438,203080,Thomas Robinson,1610612757,POR,70,47,23,873.0,105,73,30,0.695,277,0.379,10,0.393,5.2,202,75,124,0.371,352,0.574,36,0.639,4.5,307,148,154,0.482,629,0.488,46,0.527,4.7
439,201168,Tiago Splitter,1610612759,SAS,59,46,13,1271.0,123,79,43,0.642,314,0.392,9,0.403,6.1,240,101,141,0.421,444,0.541,62,0.628,4.6,363,180,184,0.496,758,0.479,71,0.528,5.1
440,1495,Tim Duncan,1610612759,SAS,74,56,18,2158.0,158,107,49,0.677,379,0.417,7,0.425,6.2,563,232,328,0.412,884,0.637,60,0.683,4.4,721,339,377,0.47,1263,0.571,67,0.603,4.8
441,203501,Tim Hardaway Jr.,1610612752,NYK,81,37,44,1875.0,19,7,12,0.368,105,0.181,2,0.184,18.0,102,24,76,0.235,258,0.395,23,0.434,10.2,121,31,88,0.256,363,0.333,25,0.358,11.5
442,202389,Timofey Mozgov,1610612743,DEN,82,36,46,1770.0,171,112,50,0.655,509,0.336,14,0.345,6.1,357,138,210,0.387,654,0.546,78,0.62,4.3,528,250,260,0.473,1163,0.454,92,0.493,4.9
443,202699,Tobias Harris,1610612753,ORL,61,16,45,1850.0,88,63,22,0.716,242,0.364,3,0.368,5.9,336,104,227,0.31,571,0.588,60,0.658,5.0,424,167,249,0.394,813,0.522,63,0.565,5.2
444,201962,Toney Douglas,1610612748,MIA,51,33,18,675.0,18,8,9,0.444,62,0.29,2,0.3,8.4,69,8,62,0.116,119,0.58,8,0.622,9.8,87,16,71,0.184,181,0.481,10,0.509,9.5
445,2754,Tony Allen,1610612763,MEM,55,31,24,1278.0,79,43,33,0.544,212,0.373,9,0.389,10.1,129,29,98,0.225,211,0.611,22,0.683,7.7,208,72,131,0.346,423,0.492,31,0.531,8.7
446,203183,Tony Mitchell,1610612749,MIL,3,0,3,10.0,1,0,1,0.0,1,1.0,0,1.0,1.8,0,0,0,0.0,1,0.0,1,0.0,0.0,1,0,1,0.0,2,0.5,1,1.0,1.8
447,203502,Tony Mitchell,1610612765,DET,21,6,15,79.0,15,12,3,0.8,27,0.556,0,0.556,6.7,11,6,5,0.545,24,0.458,4,0.55,3.1,26,18,8,0.692,51,0.51,4,0.553,5.2
448,2225,Tony Parker,1610612759,SAS,68,51,17,1997.0,17,3,14,0.176,149,0.114,7,0.12,14.8,138,10,129,0.072,272,0.507,15,0.537,11.9,155,13,143,0.084,421,0.368,22,0.388,12.2
449,203503,Tony Snell,1610612741,CHI,77,46,31,1231.0,19,8,9,0.421,60,0.317,3,0.333,11.9,105,21,85,0.2,219,0.479,16,0.517,8.2,124,29,94,0.234,279,0.444,19,0.477,8.7
450,203100,Tony Wroten,1610612755,PHI,72,18,54,1765.0,69,41,28,0.594,267,0.258,9,0.267,7.4,159,25,136,0.157,295,0.539,22,0.582,9.4,228,66,164,0.289,562,0.406,31,0.429,8.9
451,203129,Tornike Shengelia,1610612741,CHI,25,13,12,147.0,4,1,2,0.25,15,0.267,1,0.286,12.0,12,4,8,0.333,29,0.414,3,0.462,7.1,16,5,10,0.313,44,0.364,4,0.4,8.0
452,203315,Toure' Murry,1610612752,NYK,51,26,25,372.0,13,5,7,0.385,40,0.325,3,0.351,11.4,31,7,26,0.226,67,0.463,7,0.517,10.1,44,12,33,0.273,107,0.411,10,0.454,10.5
453,2566,Travis Outlaw,1610612758,SAC,63,22,41,1065.0,36,18,17,0.5,99,0.364,4,0.379,9.5,132,32,97,0.242,244,0.541,20,0.589,7.4,168,50,114,0.298,343,0.49,24,0.527,7.8
454,2772,Trevor Ariza,1610612764,WAS,76,41,35,2690.0,98,56,39,0.571,293,0.334,15,0.353,9.2,374,70,301,0.187,585,0.639,46,0.694,7.1,472,126,340,0.267,878,0.538,61,0.578,7.6
455,202344,Trevor Booker,1610612764,WAS,71,36,35,1529.0,147,76,68,0.517,390,0.377,15,0.392,7.0,228,76,156,0.333,446,0.511,48,0.573,5.7,375,152,224,0.405,836,0.449,63,0.485,6.2
456,203504,Trey Burke,1610612762,UTA,70,24,46,2262.0,37,8,29,0.216,124,0.298,5,0.311,14.2,171,15,158,0.088,334,0.512,19,0.543,10.9,208,23,187,0.111,458,0.454,24,0.479,11.5
457,202684,Tristan Thompson,1610612739,CLE,82,33,49,2594.0,269,180,84,0.669,776,0.347,22,0.357,5.9,485,161,319,0.332,849,0.571,69,0.622,5.3,754,341,403,0.452,1625,0.464,91,0.492,5.5
458,203584,Troy Daniels,1610612745,HOU,5,3,2,75.0,0,0,0,0.0,1,0.0,0,0.0,0.0,4,1,3,0.25,14,0.286,2,0.333,13.5,4,1,3,0.25,15,0.267,2,0.308,13.5
459,201951,Ty Lawson,1610612743,DEN,62,29,33,2222.0,40,11,29,0.275,191,0.209,9,0.22,16.6,175,33,142,0.189,324,0.54,25,0.585,10.9,215,44,171,0.205,515,0.417,34,0.447,12.0
460,201946,Tyler Hansbrough,1610612761,TOR,63,37,26,962.0,116,89,26,0.767,313,0.371,4,0.375,4.2,165,77,85,0.467,312,0.529,32,0.589,4.7,281,166,111,0.591,625,0.45,36,0.477,4.5
461,203092,Tyler Zeller,1610612739,CLE,70,27,43,1049.0,103,67,31,0.65,243,0.424,8,0.438,5.4,179,78,99,0.436,340,0.526,25,0.568,4.9,282,145,130,0.514,583,0.484,33,0.513,5.1
462,201936,Tyreke Evans,1610612740,NOP,72,32,40,2028.0,76,43,30,0.566,304,0.25,10,0.259,9.0,265,72,196,0.272,459,0.577,35,0.625,7.9,341,115,226,0.337,763,0.447,45,0.475,8.1
463,203116,Tyshawn Taylor,1610612751,BKN,22,10,12,262.0,3,1,1,0.333,27,0.111,3,0.125,8.5,12,4,9,0.333,33,0.364,3,0.4,10.6,15,5,10,0.333,60,0.25,6,0.278,10.3
464,2199,Tyson Chandler,1610612752,NYK,55,24,31,1662.0,159,104,47,0.654,382,0.416,12,0.43,6.1,370,121,247,0.327,612,0.605,61,0.672,4.7,529,225,294,0.425,994,0.532,73,0.574,5.1
465,2617,Udonis Haslem,1610612748,MIA,46,30,16,653.0,42,29,10,0.69,127,0.331,3,0.339,6.4,133,48,85,0.361,233,0.571,24,0.636,4.7,175,77,95,0.44,360,0.486,27,0.526,5.1
466,203505,Vander Blue,1610612738,BOS,3,1,2,15.0,0,0,0,0.0,0,0.0,0,0.0,0.0,3,0,3,0.0,3,1.0,0,1.0,13.6,3,0,3,0.0,3,1.0,0,1.0,13.6
467,203139,Viacheslav Kravtsov,1610612756,PHX,20,13,7,59.0,9,6,3,0.667,21,0.429,0,0.429,11.5,8,2,6,0.25,20,0.4,3,0.471,4.6,17,8,9,0.471,41,0.415,3,0.447,8.3
468,201964,Victor Claver,1610612757,POR,21,13,8,184.0,9,4,4,0.444,22,0.409,1,0.429,7.7,30,14,17,0.467,62,0.484,7,0.545,6.1,39,18,21,0.462,84,0.464,8,0.513,6.4
469,203506,Victor Oladipo,1610612753,ORL,80,23,57,2486.0,43,14,24,0.326,212,0.203,10,0.213,14.6,286,68,219,0.238,569,0.503,51,0.552,8.3,329,82,243,0.249,781,0.421,61,0.457,9.1
470,1713,Vince Carter,1610612742,DAL,81,49,32,1973.0,67,43,24,0.642,214,0.313,9,0.327,7.5,217,83,137,0.382,481,0.451,49,0.502,5.7,284,126,161,0.444,695,0.409,58,0.446,6.1
471,203543,Vitor Faverani,1610612738,BOS,37,13,24,488.0,42,28,12,0.667,105,0.4,3,0.412,5.7,86,36,49,0.419,182,0.473,14,0.512,4.7,128,64,61,0.5,287,0.446,17,0.474,5.0
472,201961,Wayne Ellington,1610612742,DAL,45,23,22,393.0,8,1,7,0.125,31,0.258,1,0.267,15.2,35,10,25,0.286,65,0.538,5,0.583,10.2,43,11,32,0.256,96,0.448,6,0.478,11.1
473,202325,Wesley Johnson,1610612747,LAL,79,27,52,2240.0,70,23,45,0.329,204,0.343,8,0.357,11.6,278,81,194,0.291,544,0.511,43,0.555,6.6,348,104,239,0.299,748,0.465,51,0.499,7.6
474,202083,Wesley Matthews,1610612757,POR,82,54,28,2780.0,51,19,30,0.373,216,0.236,8,0.245,12.6,238,43,198,0.181,480,0.496,51,0.555,7.9,289,62,228,0.215,696,0.415,59,0.454,8.7
475,203115,Will Barton,1610612757,POR,41,27,14,387.0,16,10,6,0.625,44,0.364,1,0.372,7.0,58,10,47,0.172,111,0.523,10,0.574,6.9,74,20,53,0.27,155,0.477,11,0.514,6.9
476,101198,Will Bynum,1610612765,DET,56,17,39,1054.0,24,8,18,0.333,124,0.194,6,0.203,15.8,75,9,68,0.12,136,0.551,3,0.564,10.6,99,17,86,0.172,260,0.381,9,0.394,12.0
477,2584,Willie Green,1610612746,LAC,55,38,17,869.0,12,5,7,0.417,35,0.343,3,0.375,19.4,66,10,53,0.152,166,0.398,13,0.431,7.3,78,15,60,0.192,201,0.388,16,0.422,9.2
478,201163,Wilson Chandler,1610612743,DEN,62,27,35,1927.0,58,37,20,0.638,187,0.31,4,0.317,9.2,236,74,168,0.314,441,0.535,49,0.602,5.6,294,111,188,0.378,628,0.468,53,0.511,6.4
479,202333,Xavier Henry,1610612747,LAL,43,16,27,908.0,25,13,13,0.52,121,0.207,4,0.214,11.3,89,19,69,0.213,198,0.449,15,0.486,8.6,114,32,82,0.281,319,0.357,19,0.38,9.2
480,2216,Zach Randolph,1610612763,MEM,79,49,30,2705.0,265,191,63,0.721,745,0.356,23,0.367,4.8,530,187,343,0.353,876,0.605,92,0.676,4.7,795,378,406,0.475,1621,0.49,115,0.528,4.7
481,2585,Zaza Pachulia,1610612749,MIL,52,10,42,1310.0,140,101,38,0.721,331,0.423,10,0.436,5.4,190,77,110,0.405,368,0.516,43,0.585,4.4,330,178,148,0.539,699,0.472,53,0.511,4.8
