,PLAYER_ID,PLAYER_NAME,TEAM_ID,TEAM_ABBREVIATION,GP,W,L,MIN,OREB,OREB_CONTEST,OREB_UNCONTEST,OREB_CONTEST_PCT,OREB_CHANCES,OREB_CHANCE_PCT,OREB_CHANCE_DEFER,OREB_CHANCE_PCT_ADJ,AVG_OREB_DIST,DREB,DREB_CONTEST,DREB_UNCONTEST,DREB_CONTEST_PCT,DREB_CHANCES,DREB_CHANCE_PCT,DREB_CHANCE_DEFER,DREB_CHANCE_PCT_ADJ,AVG_DREB_DIST,REB,REB_CONTEST,REB_UNCONTEST,REB_CONTEST_PCT,REB_CHANCES,REB_CHANCE_PCT,REB_CHANCE_DEFER,REB_CHANCE_PCT_ADJ,AVG_REB_DIST
0,201166,Aaron Brooks,1610612750,MIN,32,19,13,189.0,7,1,6,0.143,16,0.438,1,0.467,18.7,10,2,9,0.2,20,0.5,5,0.667,7.2,17,3,15,0.176,36,0.472,6,0.567,11.5
1,203932,Aaron Gordon,1610612753,ORL,58,19,39,1909.0,87,58,26,0.667,260,0.335,5,0.341,7.9,370,95,276,0.257,576,0.642,34,0.683,5.6,457,153,302,0.335,787,0.581,39,0.611,6.0
2,1626151,Aaron Harrison,1610612742,DAL,9,2,7,233.0,4,1,3,0.25,6,0.667,0,0.667,13.3,20,2,18,0.1,36,0.556,2,0.588,10.5,24,3,21,0.125,42,0.571,2,0.6,11.0
3,1627846,Abdel Nader,1610612738,BOS,47,32,15,520.0,13,7,6,0.538,43,0.302,1,0.31,6.4,58,14,44,0.241,85,0.682,8,0.753,7.2,71,21,50,0.296,124,0.573,9,0.617,7.0
4,203940,Adreian Payne,1610612753,ORL,5,0,5,43.0,2,1,1,0.5,5,0.4,0,0.4,6.0,7,2,5,0.286,11,0.636,0,0.636,4.2,9,3,6,0.333,16,0.563,0,0.563,4.6
5,201143,Al Horford,1610612738,BOS,69,44,25,2175.0,100,58,42,0.58,258,0.388,3,0.392,8.3,408,114,287,0.279,654,0.624,39,0.663,5.9,508,172,329,0.339,880,0.577,42,0.606,6.4
6,2744,Al Jefferson,1610612754,IND,36,17,19,484.0,30,23,7,0.767,96,0.313,0,0.313,4.9,113,37,76,0.327,186,0.608,13,0.653,4.4,143,60,83,0.42,269,0.532,13,0.559,4.5
7,202329,Al-Farouq Aminu,1610612757,POR,69,40,29,2072.0,97,41,53,0.423,263,0.369,4,0.375,8.9,428,112,307,0.262,672,0.637,41,0.678,5.2,525,153,360,0.291,889,0.591,45,0.622,5.9
8,1626210,Alan Williams,1610612756,PHX,5,1,4,70.0,3,1,1,0.333,20,0.15,0,0.15,9.8,19,5,14,0.263,31,0.613,0,0.613,3.4,22,6,15,0.273,48,0.458,0,0.458,4.0
9,202692,Alec Burks,1610612762,UTA,64,37,27,1059.0,19,14,5,0.737,94,0.202,5,0.213,11.1,173,32,142,0.185,277,0.625,21,0.676,6.0,192,46,147,0.24,360,0.533,26,0.575,6.5
10,1628409,Alec Peters,1610612756,PHX,20,2,18,225.0,8,7,1,0.875,21,0.381,2,0.421,5.0,29,7,23,0.241,42,0.69,2,0.725,5.7,37,14,24,0.378,59,0.627,4,0.673,5.6
11,203518,Alex Abrines,1610612760,OKC,72,42,30,1084.0,25,11,13,0.44,65,0.385,3,0.403,12.3,85,19,64,0.224,174,0.489,16,0.538,8.3,110,30,77,0.273,236,0.466,19,0.507,9.2
12,1627936,Alex Caruso,1610612747,LAL,37,16,21,562.0,15,8,7,0.533,41,0.366,4,0.405,11.2,50,6,44,0.12,88,0.568,7,0.617,10.1,65,14,51,0.215,124,0.524,11,0.575,10.4
13,203458,Alex Len,1610612756,PHX,69,20,49,1395.0,175,117,53,0.669,420,0.417,7,0.424,5.0,343,123,221,0.359,588,0.583,31,0.616,4.1,518,240,274,0.463,965,0.537,38,0.559,4.4
14,1627816,Alex Poythress,1610612754,IND,25,10,15,104.0,7,6,1,0.857,22,0.318,1,0.333,5.0,10,2,8,0.2,16,0.625,0,0.625,8.6,17,8,9,0.471,37,0.459,1,0.472,7.2
15,1628035,Alfonzo McKinnie,1610612761,TOR,14,13,1,53.0,1,1,0,1.0,2,0.5,0,0.5,1.2,6,3,3,0.5,11,0.545,3,0.75,3.6,7,4,3,0.571,12,0.583,3,0.778,3.2
16,203459,Allen Crabbe,1610612751,BKN,73,24,49,2133.0,27,11,16,0.407,139,0.194,6,0.203,13.4,288,49,238,0.17,457,0.63,22,0.662,6.8,315,60,254,0.19,579,0.544,28,0.572,7.3
17,101161,Amir Johnson,1610612755,PHI,74,47,27,1170.0,123,92,28,0.748,290,0.424,8,0.436,5.7,207,77,130,0.372,410,0.505,52,0.578,5.4,330,169,158,0.512,683,0.483,60,0.53,5.5
18,203083,Andre Drummond,1610612765,DET,78,37,41,2625.0,399,274,119,0.687,831,0.48,18,0.491,5.1,848,300,544,0.354,1239,0.684,61,0.72,3.5,1247,574,663,0.46,2001,0.623,79,0.649,4.0
19,2738,Andre Iguodala,1610612744,GSW,63,45,18,1599.0,49,16,33,0.327,133,0.368,8,0.392,10.6,190,42,147,0.221,363,0.523,28,0.567,7.7,239,58,180,0.243,480,0.498,36,0.538,8.3
20,201281,Andre Ingram,1610612747,LAL,2,1,1,64.0,1,0,1,0.0,1,1.0,0,1.0,8.2,5,0,5,0.0,7,0.714,1,0.833,10.6,6,0,6,0.0,8,0.75,1,0.857,10.2
21,203460,Andre Roberson,1610612760,OKC,36,24,12,955.0,68,46,19,0.676,165,0.412,4,0.422,7.1,102,28,73,0.275,193,0.528,15,0.573,6.1,170,74,92,0.435,354,0.48,19,0.507,6.5
22,101106,Andrew Bogut,1610612747,LAL,24,7,17,216.0,26,19,7,0.731,52,0.5,2,0.52,6.2,52,17,35,0.327,81,0.642,6,0.693,4.7,78,36,42,0.462,126,0.619,8,0.661,5.2
23,1626150,Andrew Harrison,1610612763,MEM,55,16,39,1306.0,23,3,20,0.13,121,0.19,4,0.197,11.7,106,17,91,0.16,209,0.507,18,0.555,9.7,129,20,111,0.155,323,0.399,22,0.429,10.1
24,1628510,Andrew White III,1610612737,ATL,15,1,14,209.0,4,2,2,0.5,18,0.222,0,0.222,4.9,30,1,27,0.033,51,0.588,4,0.638,7.9,34,3,29,0.088,68,0.5,4,0.531,7.5
25,203952,Andrew Wiggins,1610612750,MIN,82,47,35,2979.0,82,45,35,0.549,300,0.273,7,0.28,8.8,276,62,215,0.225,522,0.529,44,0.577,6.5,358,107,250,0.299,818,0.438,51,0.467,7.0
26,1627790,Ante Zizic,1610612739,CLE,32,21,11,214.0,24,20,5,0.833,56,0.429,2,0.444,4.2,36,10,25,0.278,67,0.537,5,0.581,5.0,60,30,30,0.5,117,0.513,7,0.545,4.7
27,1626148,Anthony Brown,1610612750,MIN,1,0,1,4.0,0,0,0,0.0,0,0.0,0,0.0,0.0,0,0,0,0.0,0,0.0,2,0.0,0.0,0,0,0,0.0,0,0.0,2,0.0,0.0
28,203076,Anthony Davis,1610612740,NOP,73,44,29,2643.0,181,121,56,0.669,419,0.432,9,0.441,6.6,621,210,413,0.338,965,0.644,49,0.678,4.8,802,331,469,0.413,1358,0.591,58,0.617,5.2
29,201229,Anthony Tolliver,1610612765,DET,79,37,42,1757.0,50,16,32,0.32,131,0.382,2,0.388,9.8,191,50,141,0.262,421,0.454,39,0.5,7.5,241,66,173,0.274,533,0.452,41,0.49,8.0
30,1628469,Antonio Blakeney,1610612741,CHI,19,3,16,314.0,4,2,2,0.5,13,0.308,0,0.308,12.9,29,2,26,0.069,56,0.518,4,0.558,6.3,33,4,28,0.121,69,0.478,4,0.508,7.1
31,1628499,Antonius Cleveland,1610612737,ATL,17,7,10,123.0,3,2,1,0.667,12,0.25,1,0.273,6.3,11,3,8,0.273,19,0.579,2,0.647,7.3,14,5,9,0.357,31,0.452,3,0.5,7.1
32,203382,Aron Baynes,1610612738,BOS,78,51,27,1433.0,128,88,38,0.688,329,0.389,6,0.396,5.0,292,103,186,0.353,547,0.534,57,0.596,4.5,420,191,224,0.455,851,0.494,63,0.533,4.6
33,201167,Arron Afflalo,1610612753,ORL,53,16,37,682.0,4,0,4,0.0,34,0.118,0,0.118,17.9,62,13,47,0.21,100,0.62,12,0.705,8.7,66,13,51,0.197,129,0.512,12,0.564,9.3
34,203085,Austin Rivers,1610612746,LAC,61,30,31,2057.0,27,9,20,0.333,124,0.218,7,0.231,12.9,118,18,99,0.153,266,0.444,32,0.504,8.4,145,27,119,0.186,384,0.378,39,0.42,9.4
35,202340,Avery Bradley,1610612746,LAC,46,22,24,1433.0,22,11,11,0.5,107,0.206,8,0.222,8.1,94,10,84,0.106,169,0.556,20,0.631,7.3,116,21,95,0.181,273,0.425,28,0.473,7.5
36,1628389,Bam Adebayo,1610612748,MIA,68,33,35,1348.0,116,79,37,0.681,282,0.411,5,0.419,6.4,260,83,177,0.319,416,0.625,26,0.667,5.5,376,162,214,0.431,663,0.567,31,0.595,5.8
37,203463,Ben McLemore,1610612763,MEM,56,7,49,1091.0,34,15,18,0.441,108,0.315,0,0.315,9.4,105,8,96,0.076,197,0.533,28,0.621,7.6,139,23,114,0.165,296,0.47,28,0.519,8.0
38,1628500,Ben Moore,1610612754,IND,2,1,1,9.0,0,0,0,0.0,0,0.0,0,0.0,0.0,1,0,1,0.0,2,0.5,0,0.5,9.7,1,0,1,0.0,2,0.5,0,0.5,9.7
39,1627732,Ben Simmons,1610612755,PHI,80,51,29,2703.0,145,71,72,0.49,413,0.351,9,0.359,10.1,512,101,408,0.197,777,0.659,35,0.69,6.6,657,172,480,0.262,1110,0.592,44,0.616,7.4
40,202687,Bismack Biyombo,1610612753,ORL,82,25,57,1495.0,144,97,44,0.674,381,0.378,8,0.386,5.2,324,105,217,0.324,582,0.557,35,0.592,4.3,468,202,261,0.432,935,0.501,43,0.525,4.6
41,201933,Blake Griffin,1610612765,DET,58,28,30,1970.0,73,46,28,0.63,269,0.271,12,0.284,8.5,355,84,267,0.237,598,0.594,39,0.635,4.7,428,130,295,0.304,831,0.515,51,0.549,5.4
42,1626246,Boban Marjanovic,1610612746,LAC,39,18,21,338.0,48,38,10,0.792,110,0.436,4,0.453,3.2,96,35,61,0.365,151,0.636,14,0.701,3.8,144,73,71,0.507,253,0.569,18,0.613,3.6
43,201628,Bobby Brown,1610612745,HOU,20,17,3,115.0,0,0,1,0.0,1,0.0,0,0.0,0.0,7,0,7,0.0,11,0.636,1,0.7,16.3,7,0,8,0.0,11,0.636,1,0.7,16.2
44,1626171,Bobby Portis,1610612741,CHI,73,25,48,1642.0,159,102,50,0.642,373,0.426,5,0.432,5.7,339,66,273,0.195,541,0.627,34,0.669,4.8,498,168,323,0.337,883,0.564,39,0.59,5.1
45,203992,Bogdan Bogdanovic,1610612758,SAC,78,26,52,2175.0,31,19,12,0.613,139,0.223,5,0.231,8.1,192,37,154,0.193,365,0.526,38,0.587,7.5,223,56,166,0.251,492,0.453,43,0.497,7.6
46,202711,Bojan Bogdanovic,1610612754,IND,80,47,33,2464.0,30,7,23,0.233,155,0.194,6,0.201,15.3,240,36,201,0.15,395,0.608,25,0.649,7.1,270,43,224,0.159,528,0.511,31,0.543,8.0
47,203078,Bradley Beal,1610612764,WAS,82,43,39,2977.0,61,27,34,0.443,254,0.24,10,0.25,12.3,302,57,242,0.189,521,0.58,28,0.613,8.1,363,84,276,0.231,757,0.48,38,0.505,8.8
48,201148,Brandan Wright,1610612745,HOU,27,10,17,370.0,33,21,12,0.636,63,0.524,2,0.541,5.5,59,28,31,0.475,116,0.509,7,0.541,5.6,92,49,43,0.533,174,0.529,9,0.558,5.6
49,1627742,Brandon Ingram,1610612747,LAL,59,27,32,1975.0,57,33,23,0.579,209,0.273,7,0.282,8.4,257,57,201,0.222,417,0.616,26,0.657,6.5,314,90,224,0.287,619,0.507,33,0.536,6.8
50,201943,Brandon Jennings,1610612749,MIL,14,8,6,205.0,5,2,3,0.4,15,0.333,0,0.333,12.6,26,1,25,0.038,47,0.553,2,0.578,8.6,31,3,28,0.097,61,0.508,2,0.525,9.2
51,203464,Brandon Paul,1610612759,SAS,64,38,26,576.0,6,2,4,0.333,33,0.182,1,0.188,8.6,62,11,51,0.177,119,0.521,11,0.574,8.0,68,13,55,0.191,147,0.463,12,0.504,8.1
52,1627362,Briante Weber,1610612763,MEM,18,8,10,237.0,8,0,8,0.0,22,0.364,1,0.381,18.3,27,5,22,0.185,43,0.628,2,0.659,7.6,35,5,30,0.143,65,0.538,3,0.565,10.1
53,1627744,Brice Johnson,1610612763,MEM,18,2,16,98.0,9,5,3,0.556,22,0.409,0,0.409,7.3,22,9,10,0.409,27,0.815,1,0.846,3.7,31,14,13,0.452,44,0.705,1,0.721,4.8
54,201572,Brook Lopez,1610612747,LAL,74,34,40,1735.0,74,47,25,0.635,158,0.468,1,0.471,7.3,220,99,115,0.45,428,0.514,35,0.56,6.1,294,146,140,0.497,573,0.513,36,0.547,6.4
55,203998,Bruno Caboclo,1610612758,SAC,12,4,8,106.0,7,6,1,0.857,20,0.35,0,0.35,6.2,15,5,10,0.333,31,0.484,4,0.556,5.4,22,11,11,0.5,47,0.468,4,0.512,5.6
56,1627854,Bryn Forbes,1610612759,SAS,80,46,34,1517.0,12,2,11,0.167,49,0.245,1,0.25,16.4,98,14,84,0.143,198,0.495,23,0.56,9.6,110,16,95,0.145,243,0.453,24,0.502,10.5
57,1627741,Buddy Hield,1610612758,SAC,80,27,53,2024.0,55,18,36,0.327,178,0.309,6,0.32,11.2,252,25,225,0.099,438,0.575,34,0.624,7.1,307,43,261,0.14,612,0.502,40,0.537,7.8
58,203710,C.J. Williams,1610612746,LAC,38,17,21,707.0,12,4,8,0.333,39,0.308,2,0.324,9.5,44,9,35,0.205,88,0.5,9,0.557,9.7,56,13,43,0.232,126,0.444,11,0.487,9.7
59,203468,CJ McCollum,1610612757,POR,81,48,33,2924.0,53,22,30,0.415,236,0.225,12,0.237,11.5,268,38,229,0.142,472,0.568,29,0.605,9.9,321,60,259,0.187,700,0.459,41,0.487,10.2
60,101139,CJ Miles,1610612761,TOR,70,50,20,1337.0,18,7,12,0.389,71,0.254,6,0.277,16.0,134,24,110,0.179,225,0.596,7,0.615,9.1,152,31,122,0.204,287,0.53,13,0.555,9.9
61,1628403,Caleb Swanigan,1610612757,POR,27,16,11,189.0,15,13,2,0.867,55,0.273,1,0.278,3.4,39,10,29,0.256,64,0.609,8,0.696,4.4,54,23,31,0.426,114,0.474,9,0.514,4.1
62,1626166,Cameron Payne,1610612741,CHI,25,7,18,582.0,18,8,10,0.444,71,0.254,2,0.261,13.6,51,4,47,0.078,90,0.567,8,0.622,8.6,69,12,57,0.174,154,0.448,10,0.479,9.9
63,1627747,Caris LeVert,1610612751,BKN,69,24,45,1802.0,53,28,26,0.528,219,0.242,17,0.262,8.1,202,38,165,0.188,339,0.596,25,0.643,6.8,255,66,191,0.259,552,0.462,42,0.5,7.0
64,2546,Carmelo Anthony,1610612760,OKC,75,46,29,2397.0,62,37,26,0.597,207,0.3,8,0.312,10.4,366,73,292,0.199,647,0.566,38,0.601,5.2,428,110,318,0.257,818,0.523,46,0.554,6.0
65,1626224,Cedi Osman,1610612739,CLE,61,35,26,672.0,19,8,10,0.421,84,0.226,3,0.235,10.1,101,14,86,0.139,145,0.697,13,0.765,6.0,120,22,96,0.183,210,0.571,16,0.619,6.7
66,202718,Chandler Parsons,1610612763,MEM,35,11,24,676.0,14,5,9,0.357,56,0.25,2,0.259,9.0,73,10,62,0.137,125,0.584,8,0.624,6.9,87,15,71,0.172,170,0.512,10,0.544,7.2
67,101112,Channing Frye,1610612747,LAL,53,28,25,695.0,12,9,3,0.75,33,0.364,2,0.387,9.9,123,37,86,0.301,227,0.542,22,0.6,4.8,135,46,89,0.341,250,0.54,24,0.597,5.2
68,1628429,Charles Cooke,1610612740,NOP,13,8,5,38.0,0,0,0,0.0,0,0.0,1,0.0,0.0,2,1,1,0.5,2,1.0,0,1.0,7.2,2,1,1,0.5,2,1.0,1,2.0,7.2
69,1627767,Cheick Diallo,1610612740,NOP,52,29,23,581.0,47,30,15,0.638,147,0.32,2,0.324,6.5,164,46,113,0.28,268,0.612,14,0.646,4.2,211,76,128,0.36,395,0.534,16,0.557,4.7
70,1627778,Chinanu Onuaku,1610612745,HOU,1,0,1,22.0,1,1,0,1.0,6,0.167,0,0.167,12.8,3,1,2,0.333,8,0.375,1,0.429,3.8,4,2,2,0.5,14,0.286,1,0.308,6.1
71,1628449,Chris Boucher,1610612744,GSW,1,1,0,1.0,0,0,0,0.0,1,0.0,0,0.0,0.0,1,0,1,0.0,1,1.0,0,1.0,0.9,1,0,1,0.0,1,1.0,0,1.0,0.9
72,1626191,Chris McCullough,1610612764,WAS,19,11,8,90.0,7,4,3,0.571,20,0.35,1,0.368,9.4,18,3,15,0.167,27,0.667,5,0.818,4.2,25,7,18,0.28,45,0.556,6,0.641,5.7
73,101108,Chris Paul,1610612745,HOU,58,50,8,1847.0,37,8,27,0.216,121,0.306,3,0.314,13.4,276,45,232,0.163,506,0.545,45,0.599,7.1,313,53,259,0.169,619,0.506,48,0.548,7.8
74,203991,Clint Capela,1610612745,HOU,73,62,11,2009.0,240,157,80,0.654,504,0.476,8,0.484,6.4,556,165,387,0.297,846,0.657,49,0.698,4.5,796,322,467,0.405,1328,0.599,57,0.626,5.0
75,203469,Cody Zeller,1610612766,CHA,33,14,19,627.0,67,48,19,0.716,186,0.36,2,0.364,4.6,110,43,67,0.391,193,0.57,12,0.608,5.3,177,91,86,0.514,375,0.472,14,0.49,5.0
76,202332,Cole Aldrich,1610612750,MIN,21,14,7,49.0,3,2,1,0.667,14,0.214,0,0.214,3.0,12,2,10,0.167,15,0.8,2,0.923,2.8,15,4,11,0.267,25,0.6,2,0.652,2.9
77,201147,Corey Brewer,1610612760,OKC,72,32,40,1209.0,43,14,29,0.326,139,0.309,3,0.316,10.7,111,22,87,0.198,194,0.572,22,0.645,7.8,154,36,116,0.234,328,0.47,25,0.508,8.6
78,202709,Cory Joseph,1610612754,IND,82,48,34,2210.0,39,7,31,0.179,124,0.315,4,0.325,14.0,224,42,185,0.188,425,0.527,36,0.576,8.4,263,49,216,0.186,541,0.486,40,0.525,9.2
79,201584,Courtney Lee,1610612752,NYK,75,26,49,2278.0,29,11,18,0.379,106,0.274,2,0.279,11.6,190,26,163,0.137,319,0.596,23,0.642,9.9,219,37,181,0.169,420,0.521,25,0.554,10.1
80,1626245,Cristiano Felicio,1610612741,CHI,55,13,42,977.0,83,61,21,0.735,242,0.343,6,0.352,5.4,150,50,100,0.333,264,0.568,24,0.625,4.8,233,111,121,0.476,494,0.472,30,0.502,5.0
81,1626156,D'Angelo Russell,1610612751,BKN,48,16,32,1234.0,30,11,20,0.367,95,0.316,3,0.326,13.3,159,18,139,0.113,265,0.6,15,0.636,7.0,189,29,159,0.153,347,0.545,18,0.574,8.0
82,201571,D.J. Augustin,1610612753,ORL,75,23,52,1760.0,30,4,24,0.133,134,0.224,3,0.229,15.1,130,13,116,0.1,255,0.51,26,0.568,10.4,160,17,140,0.106,379,0.422,29,0.457,11.3
83,1628391,D.J. Wilson,1610612749,MIL,22,12,10,71.0,2,0,2,0.0,4,0.5,0,0.5,13.0,8,2,6,0.25,9,0.889,0,0.889,4.7,10,2,8,0.2,12,0.833,0,0.833,6.4
84,1626177,Dakari Johnson,1610612760,OKC,29,21,8,144.0,15,10,5,0.667,36,0.417,2,0.441,6.2,15,6,9,0.4,38,0.395,4,0.441,8.5,30,16,14,0.533,73,0.411,6,0.448,7.3
85,1627745,Damian Jones,1610612744,GSW,15,7,8,89.0,5,5,0,1.0,16,0.313,0,0.313,5.6,9,3,6,0.333,25,0.36,5,0.45,4.7,14,8,6,0.571,40,0.35,5,0.4,5.0
86,203081,Damian Lillard,1610612757,POR,73,44,29,2670.0,62,20,41,0.323,243,0.255,11,0.267,13.5,263,33,227,0.125,467,0.563,29,0.6,8.5,325,53,268,0.163,704,0.462,40,0.489,9.5
87,2863,Damien Wilkins,1610612754,IND,19,10,9,152.0,5,4,1,0.8,13,0.385,1,0.417,9.2,11,1,10,0.091,17,0.647,2,0.733,6.3,16,5,11,0.313,29,0.552,3,0.615,7.2
88,1627814,Damion Lee,1610612737,ATL,15,4,11,404.0,11,3,8,0.273,46,0.239,2,0.25,9.8,60,7,53,0.117,93,0.645,4,0.674,7.1,71,10,61,0.141,139,0.511,6,0.534,7.6
89,1628422,Damyean Dotson,1610612752,NYK,44,11,33,474.0,9,1,8,0.111,27,0.333,0,0.333,15.5,75,11,64,0.147,108,0.694,5,0.728,6.7,84,12,72,0.143,132,0.636,5,0.661,7.6
90,1627772,Daniel Hamilton,1610612760,OKC,6,5,1,28.0,0,0,0,0.0,5,0.0,1,0.0,0.0,5,0,5,0.0,9,0.556,1,0.625,3.8,5,0,5,0.0,13,0.385,2,0.455,3.8
91,1628464,Daniel Theis,1610612738,BOS,60,41,19,894.0,86,61,25,0.709,206,0.417,2,0.422,6.4,173,84,89,0.486,308,0.562,31,0.625,4.3,259,145,114,0.56,487,0.532,33,0.57,5.0
92,201568,Danilo Gallinari,1610612746,LAC,21,11,10,671.0,9,4,5,0.444,52,0.173,3,0.184,9.9,92,23,69,0.25,156,0.59,14,0.648,6.7,101,27,74,0.267,206,0.49,17,0.534,7.0
93,201980,Danny Green,1610612759,SAS,70,40,30,1791.0,41,17,24,0.415,129,0.318,4,0.328,11.3,208,35,174,0.168,397,0.524,34,0.573,6.0,249,52,198,0.209,517,0.482,38,0.52,6.9
94,201967,Dante Cunningham,1610612751,BKN,71,33,38,1518.0,76,41,34,0.539,211,0.36,3,0.365,6.9,212,56,155,0.264,401,0.529,25,0.564,6.1,288,97,189,0.337,585,0.492,28,0.517,6.3
95,203957,Dante Exum,1610612762,UTA,14,10,4,235.0,4,3,1,0.75,17,0.235,1,0.25,5.8,22,4,18,0.182,49,0.449,0,0.449,5.5,26,7,19,0.269,66,0.394,1,0.4,5.6
96,1627863,Danuel House,1610612756,PHX,23,6,17,403.0,13,7,6,0.538,37,0.351,0,0.351,8.3,63,8,55,0.127,91,0.692,7,0.75,7.3,76,15,61,0.197,127,0.598,7,0.633,7.4
97,203967,Dario Saric,1610612755,PHI,77,49,28,2276.0,152,92,57,0.605,387,0.393,13,0.406,7.1,364,85,279,0.234,703,0.518,61,0.567,5.0,516,177,336,0.343,1051,0.491,74,0.528,5.6
98,203121,Darius Miller,1610612740,NOP,80,47,33,1903.0,17,4,12,0.235,39,0.436,3,0.472,17.2,138,35,102,0.254,281,0.491,31,0.552,8.6,155,39,114,0.252,315,0.492,34,0.552,9.5
99,201589,Darrell Arthur,1610612743,DEN,19,12,7,141.0,3,2,1,0.667,10,0.3,1,0.333,7.3,12,7,5,0.583,28,0.429,4,0.5,4.4,15,9,6,0.6,36,0.417,5,0.484,5.0
100,201954,Darren Collison,1610612754,IND,69,39,30,2018.0,37,5,33,0.135,109,0.339,3,0.349,16.4,141,12,126,0.085,264,0.534,17,0.571,11.1,178,17,159,0.096,369,0.482,20,0.51,12.2
101,1626199,Darrun Hilliard,1610612759,SAS,14,8,6,95.0,0,0,0,0.0,5,0.0,0,0.0,0.0,7,2,5,0.286,15,0.467,2,0.538,7.5,7,2,5,0.286,20,0.35,2,0.389,7.5
102,1628021,David Nwaba,1610612741,CHI,70,26,44,1646.0,89,46,41,0.517,271,0.328,11,0.342,7.8,237,44,193,0.186,431,0.55,42,0.609,6.9,326,90,234,0.276,683,0.477,53,0.517,7.1
103,204065,David Stockton,1610612762,UTA,3,3,0,9.0,0,0,0,0.0,0,0.0,0,0.0,0.0,0,0,0,0.0,0,0.0,1,0.0,0.0,0,0,0,0.0,0,0.0,1,0.0,0.0
104,2561,David West,1610612744,GSW,72,51,21,986.0,63,41,21,0.651,139,0.453,3,0.463,6.8,174,68,106,0.391,317,0.549,38,0.624,5.3,237,109,127,0.46,446,0.531,41,0.585,5.7
105,202722,Davis Bertans,1610612759,SAS,77,43,34,1086.0,18,13,5,0.722,52,0.346,3,0.367,6.1,135,42,93,0.311,263,0.513,17,0.549,5.4,153,55,98,0.359,306,0.5,20,0.535,5.5
106,1628432,Davon Reed,1610612756,PHX,21,2,19,242.0,2,0,2,0.0,17,0.118,0,0.118,17.6,37,3,33,0.081,63,0.587,7,0.661,5.9,39,3,35,0.077,78,0.5,7,0.549,6.5
107,1628368,De'Aaron Fox,1610612758,SAC,73,24,49,2026.0,33,15,18,0.455,147,0.224,6,0.234,12.2,171,19,153,0.111,327,0.523,23,0.563,9.0,204,34,171,0.167,470,0.434,29,0.463,9.5
108,201599,DeAndre Jordan,1610612746,LAC,77,39,38,2423.0,329,229,101,0.696,707,0.465,8,0.471,5.0,842,208,631,0.247,1197,0.703,53,0.736,4.5,1171,437,732,0.373,1841,0.636,61,0.658,4.6
109,202732,DeAndre Liggins,1610612740,NOP,57,34,23,708.0,7,2,5,0.286,31,0.226,3,0.25,13.5,67,20,45,0.299,110,0.609,12,0.684,6.5,74,22,50,0.297,140,0.529,15,0.592,7.1
110,1627761,DeAndre' Bembry,1610612737,ATL,25,8,17,454.0,8,3,5,0.375,34,0.235,2,0.25,14.0,64,14,50,0.219,108,0.593,7,0.634,7.3,72,17,55,0.236,141,0.511,9,0.545,8.1
111,201942,DeMar DeRozan,1610612761,TOR,80,57,23,2712.0,59,19,40,0.322,234,0.252,11,0.265,10.5,256,39,216,0.152,428,0.598,28,0.64,8.9,315,58,256,0.184,646,0.488,39,0.519,9.2
112,202326,DeMarcus Cousins,1610612740,NOP,46,26,20,1678.0,99,70,26,0.707,274,0.361,4,0.367,5.9,495,165,332,0.333,739,0.67,32,0.7,4.2,594,235,358,0.396,970,0.612,36,0.636,4.5
113,201960,DeMarre Carroll,1610612751,BKN,71,24,47,2122.0,103,56,48,0.544,332,0.31,13,0.323,9.0,360,84,276,0.233,624,0.577,45,0.622,6.1,463,140,324,0.302,925,0.501,58,0.534,6.8
114,1627749,Dejounte Murray,1610612759,SAS,81,47,34,1743.0,110,54,54,0.491,302,0.364,11,0.378,8.3,349,60,289,0.172,595,0.587,43,0.632,5.7,459,114,343,0.248,884,0.519,54,0.553,6.4
115,1626153,Delon Wright,1610612761,TOR,69,49,20,1433.0,45,18,27,0.4,165,0.273,7,0.285,7.9,153,18,133,0.118,284,0.539,21,0.582,8.2,198,36,160,0.182,443,0.447,28,0.477,8.1
116,1627743,Demetrius Jackson,1610612755,PHI,14,12,2,76.0,5,2,3,0.4,7,0.714,0,0.714,12.7,7,1,6,0.143,11,0.636,3,0.875,8.2,12,3,9,0.25,18,0.667,3,0.8,10.1
117,203471,Dennis Schroder,1610612737,ATL,66,21,45,2041.0,43,10,33,0.233,213,0.202,7,0.209,14.2,163,15,148,0.092,312,0.522,27,0.572,9.2,206,25,181,0.121,521,0.395,34,0.423,10.2
118,1628372,Dennis Smith Jr.,1610612742,DAL,69,22,47,2049.0,50,20,29,0.4,259,0.193,12,0.202,10.1,210,34,177,0.162,422,0.498,38,0.547,7.5,260,54,206,0.208,677,0.384,50,0.415,8.0
119,1627756,Denzel Valentine,1610612741,CHI,77,26,51,2095.0,48,17,31,0.354,154,0.312,3,0.318,13.6,345,63,282,0.183,585,0.59,53,0.648,6.0,393,80,313,0.204,725,0.542,56,0.587,6.9
120,202324,Derrick Favors,1610612762,UTA,77,46,31,2153.0,198,141,52,0.712,467,0.424,9,0.432,4.9,354,135,218,0.381,638,0.555,44,0.596,4.7,552,276,270,0.5,1066,0.518,53,0.545,4.8
121,1627884,Derrick Jones Jr.,1610612748,MIA,20,9,11,245.0,21,12,9,0.571,34,0.618,1,0.636,8.0,17,0,17,0.0,33,0.515,2,0.548,7.4,38,12,26,0.316,67,0.567,3,0.594,7.7
122,201565,Derrick Rose,1610612750,MIN,25,15,10,419.0,13,5,6,0.385,35,0.371,0,0.371,13.0,22,6,16,0.273,42,0.524,6,0.611,9.7,35,11,22,0.314,77,0.455,6,0.493,10.8
123,1628476,Derrick Walton Jr.,1610612748,MIA,16,8,8,147.0,2,0,2,0.0,5,0.4,0,0.4,19.6,14,3,11,0.214,29,0.483,5,0.583,8.5,16,3,13,0.188,34,0.471,5,0.552,9.9
124,1628401,Derrick White,1610612759,SAS,17,7,10,139.0,5,2,3,0.4,13,0.385,0,0.385,12.5,21,8,13,0.381,33,0.636,1,0.656,4.9,26,10,16,0.385,45,0.578,1,0.591,6.3
125,202682,Derrick Williams,1610612747,LAL,2,1,1,9.0,0,0,0,0.0,3,0.0,0,0.0,0.0,1,0,1,0.0,1,1.0,0,1.0,3.5,1,0,1,0.0,3,0.333,0,0.333,3.5
126,1626164,Devin Booker,1610612756,PHX,54,16,38,1865.0,26,10,17,0.385,157,0.166,6,0.172,12.1,218,24,193,0.11,373,0.584,31,0.637,7.8,244,34,210,0.139,523,0.467,37,0.502,8.4
127,2734,Devin Harris,1610612743,DEN,71,33,38,1340.0,12,3,9,0.25,69,0.174,4,0.185,17.3,115,26,90,0.226,207,0.556,19,0.612,8.5,127,29,99,0.228,269,0.472,23,0.516,9.3
128,1628421,Devin Robinson,1610612764,WAS,1,0,1,13.0,2,1,0,0.5,4,0.5,0,0.5,2.2,3,1,2,0.333,4,0.75,0,0.75,5.6,5,2,2,0.4,8,0.625,0,0.625,4.7
129,203473,Dewayne Dedmon,1610612737,ATL,61,18,43,1520.0,100,62,37,0.62,267,0.375,4,0.38,6.3,381,119,258,0.312,586,0.65,23,0.677,4.4,481,181,295,0.376,817,0.589,27,0.609,4.8
130,1627738,Deyonta Davis,1610612763,MEM,62,16,46,943.0,75,41,29,0.547,163,0.46,3,0.469,5.9,175,57,117,0.326,309,0.566,24,0.614,4.8,250,98,146,0.392,454,0.551,27,0.585,5.1
131,1628415,Dillon Brooks,1610612763,MEM,81,21,60,2329.0,49,21,27,0.429,183,0.268,2,0.271,9.0,208,47,162,0.226,377,0.552,27,0.594,6.9,257,68,189,0.265,545,0.472,29,0.498,7.3
132,203079,Dion Waiters,1610612748,MIA,29,15,14,893.0,8,1,7,0.125,60,0.133,3,0.14,15.5,68,6,62,0.088,129,0.527,10,0.571,9.3,76,7,69,0.092,187,0.406,13,0.437,9.9
133,1717,Dirk Nowitzki,1610612742,DAL,77,24,53,1900.0,22,14,6,0.636,79,0.278,3,0.289,9.7,416,144,271,0.346,677,0.614,50,0.663,4.3,438,158,277,0.361,726,0.603,53,0.651,4.5
134,1627734,Domantas Sabonis,1610612754,IND,74,45,29,1810.0,165,118,47,0.715,446,0.37,11,0.379,6.1,407,136,267,0.334,690,0.59,44,0.63,4.1,572,254,314,0.444,1094,0.523,55,0.551,4.7
135,1628378,Donovan Mitchell,1610612762,UTA,79,46,33,2638.0,52,23,30,0.442,251,0.207,11,0.217,11.8,244,44,199,0.18,460,0.53,29,0.566,8.4,296,67,229,0.226,697,0.425,40,0.451,9.0
136,1627827,Dorian Finney-Smith,1610612742,DAL,21,4,17,448.0,22,11,11,0.5,55,0.4,0,0.4,8.0,53,14,39,0.264,98,0.541,14,0.631,4.8,75,25,50,0.333,147,0.51,14,0.564,5.7
137,203926,Doug McDermott,1610612742,DAL,80,29,51,1736.0,40,25,15,0.625,133,0.301,3,0.308,6.1,159,40,119,0.252,288,0.552,29,0.614,6.5,199,65,134,0.327,412,0.483,32,0.524,6.5
138,1627733,Dragan Bender,1610612756,PHX,82,21,61,2069.0,40,22,17,0.55,164,0.244,6,0.253,8.9,321,77,244,0.24,594,0.54,55,0.596,4.8,361,99,261,0.274,720,0.501,61,0.548,5.2
139,203110,Draymond Green,1610612744,GSW,69,47,22,2252.0,75,52,20,0.693,213,0.352,6,0.362,6.4,455,131,320,0.288,790,0.576,44,0.61,5.0,530,183,340,0.345,960,0.552,50,0.582,5.2
140,1628407,Dwayne Bacon,1610612766,CHA,53,25,28,713.0,4,1,3,0.25,38,0.105,1,0.108,12.5,120,27,93,0.225,179,0.67,11,0.714,6.0,124,28,96,0.226,207,0.599,12,0.636,6.2
141,202779,Dwight Buycks,1610612765,DET,29,10,19,427.0,12,3,9,0.25,48,0.25,2,0.261,12.0,29,3,26,0.103,76,0.382,9,0.433,8.2,41,6,35,0.146,124,0.331,11,0.363,9.3
142,2730,Dwight Howard,1610612766,CHA,81,35,46,2463.0,255,173,73,0.678,620,0.411,11,0.419,4.1,757,237,516,0.313,1118,0.677,68,0.721,3.8,1012,410,589,0.405,1694,0.597,79,0.627,3.9
143,203939,Dwight Powell,1610612742,DAL,79,23,56,1672.0,135,80,55,0.593,386,0.35,6,0.355,6.6,309,83,225,0.269,522,0.592,48,0.652,5.3,444,163,280,0.367,872,0.509,54,0.543,5.7
144,2548,Dwyane Wade,1610612748,MIA,67,37,30,1536.0,50,29,21,0.58,174,0.287,6,0.298,8.3,202,45,158,0.223,367,0.55,37,0.612,6.5,252,74,179,0.294,531,0.475,43,0.516,6.9
145,202734,E'Twaun Moore,1610612740,NOP,80,47,33,2528.0,55,23,33,0.418,162,0.34,4,0.348,10.2,180,36,142,0.2,354,0.508,35,0.564,9.5,235,59,175,0.251,505,0.465,39,0.504,9.7
146,202334,Ed Davis,1610612757,POR,78,48,30,1471.0,183,122,57,0.667,475,0.385,11,0.394,5.3,392,122,265,0.311,653,0.6,54,0.654,4.0,575,244,322,0.424,1102,0.522,65,0.554,4.4
147,1628410,Edmond Sumner,1610612754,IND,1,0,1,2.0,0,0,0,0.0,0,0.0,0,0.0,0.0,1,0,1,0.0,1,1.0,0,1.0,6.5,1,0,1,0.0,1,1.0,0,1.0,6.5
148,202327,Ekpe Udoh,1610612762,UTA,63,36,27,810.0,68,39,29,0.574,155,0.439,3,0.447,7.5,82,29,54,0.354,198,0.414,24,0.471,5.4,150,68,83,0.453,343,0.437,27,0.475,6.4
149,203901,Elfrid Payton,1610612756,PHX,63,13,50,1808.0,64,30,33,0.469,239,0.268,7,0.276,10.9,210,26,181,0.124,338,0.621,17,0.654,8.0,274,56,214,0.204,570,0.481,24,0.502,8.7
150,2731,Emeka Okafor,1610612740,NOP,26,16,10,353.0,47,23,23,0.489,83,0.566,0,0.566,5.7,73,25,47,0.342,159,0.459,17,0.514,5.3,120,48,70,0.4,239,0.502,17,0.541,5.5
151,1626144,Emmanuel Mudiay,1610612752,NYK,64,29,35,1244.0,26,13,13,0.5,125,0.208,6,0.218,10.2,126,20,104,0.159,210,0.6,12,0.636,8.0,152,33,117,0.217,330,0.461,18,0.487,8.4
152,202683,Enes Kanter,1610612752,NYK,70,26,44,1807.0,271,204,56,0.753,637,0.425,12,0.434,4.6,504,144,360,0.286,824,0.612,66,0.665,4.0,775,348,416,0.449,1432,0.541,78,0.572,4.2
153,202339,Eric Bledsoe,1610612749,MIL,74,40,34,2322.0,51,23,29,0.451,203,0.251,5,0.258,8.6,233,43,187,0.185,447,0.521,37,0.568,9.0,284,66,216,0.232,633,0.449,42,0.481,8.9
154,201569,Eric Gordon,1610612745,HOU,68,55,13,2121.0,25,9,18,0.36,117,0.214,9,0.231,14.7,141,17,122,0.121,243,0.58,14,0.616,8.9,166,26,140,0.157,352,0.472,23,0.505,9.9
155,203961,Eric Moreland,1610612765,DET,67,32,35,805.0,81,52,29,0.642,240,0.338,5,0.345,4.4,197,59,137,0.299,338,0.583,21,0.621,4.1,278,111,166,0.399,560,0.496,26,0.521,4.2
156,1628571,Erik McCree,1610612762,UTA,4,4,0,8.0,0,0,0,0.0,0,0.0,0,0.0,0.0,1,0,1,0.0,1,1.0,0,1.0,0.8,1,0,1,0.0,1,1.0,0,1.0,0.8
157,101141,Ersan Ilyasova,1610612755,PHI,69,36,33,1730.0,118,76,41,0.644,286,0.413,8,0.424,6.4,287,86,199,0.3,488,0.588,28,0.624,5.4,405,162,240,0.4,743,0.545,36,0.573,5.7
158,203095,Evan Fournier,1610612753,ORL,57,20,37,1837.0,23,10,14,0.435,126,0.183,2,0.185,12.6,157,27,128,0.172,300,0.523,28,0.577,8.1,180,37,142,0.206,416,0.433,30,0.466,8.7
159,202323,Evan Turner,1610612757,POR,79,48,31,2034.0,30,12,17,0.4,153,0.196,4,0.201,10.6,214,59,156,0.276,400,0.535,47,0.606,5.7,244,71,173,0.291,538,0.454,51,0.501,6.3
160,1626163,Frank Kaminsky,1610612766,CHA,79,35,44,1835.0,46,22,24,0.478,160,0.288,8,0.303,9.7,242,44,198,0.182,426,0.568,36,0.621,6.1,288,66,222,0.229,562,0.512,44,0.556,6.6
161,1628412,Frank Mason,1610612758,SAC,52,17,35,984.0,30,11,19,0.367,89,0.337,4,0.353,12.0,100,14,83,0.14,156,0.641,8,0.676,8.3,130,25,102,0.192,243,0.535,12,0.563,9.2
162,1628373,Frank Ntilikina,1610612752,NYK,77,27,50,1693.0,37,12,26,0.324,101,0.366,3,0.378,13.3,139,30,108,0.216,262,0.531,22,0.579,9.4,176,42,134,0.239,359,0.49,25,0.527,10.3
163,1627832,Fred VanVleet,1610612761,TOR,76,55,21,1520.0,25,7,17,0.28,133,0.188,4,0.194,17.9,159,25,134,0.157,326,0.488,23,0.525,8.8,184,32,151,0.174,456,0.404,27,0.429,10.0
164,1627788,Furkan Korkmaz,1610612755,PHI,14,11,3,80.0,2,0,2,0.0,3,0.667,0,0.667,7.7,9,0,9,0.0,11,0.818,0,0.818,8.5,11,0,11,0.0,13,0.846,0,0.846,8.4
165,202066,Garrett Temple,1610612758,SAC,65,23,42,1615.0,22,12,10,0.545,90,0.244,3,0.253,8.4,130,19,107,0.146,239,0.544,20,0.594,8.3,152,31,117,0.204,315,0.483,23,0.521,8.3
166,203914,Gary Harris,1610612743,DEN,67,37,30,2305.0,37,16,20,0.432,130,0.285,1,0.287,10.3,139,19,116,0.137,229,0.607,16,0.653,9.3,176,35,136,0.199,357,0.493,17,0.518,9.5
167,1627780,Gary Payton II,1610612747,LAL,23,10,13,221.0,13,8,6,0.615,37,0.351,1,0.361,5.4,31,6,25,0.194,54,0.574,3,0.608,4.5,44,14,31,0.318,88,0.5,4,0.524,4.8
168,201588,George Hill,1610612739,CLE,67,28,39,1812.0,42,15,26,0.357,113,0.372,5,0.389,14.2,139,26,112,0.187,262,0.531,21,0.577,8.7,181,41,138,0.227,372,0.487,26,0.523,10.0
169,1627777,Georges Niang,1610612762,UTA,9,9,0,32.0,3,0,3,0.0,4,0.75,0,0.75,16.6,6,0,5,0.0,7,0.857,0,0.857,7.6,9,0,8,0.0,10,0.9,0,0.9,10.9
170,1627834,Georgios Papagiannis,1610612757,POR,17,3,14,122.0,13,10,1,0.769,27,0.481,0,0.481,4.5,24,9,15,0.375,41,0.585,0,0.585,3.8,37,19,16,0.514,62,0.597,0,0.597,4.0
171,101123,Gerald Green,1610612745,HOU,41,33,8,929.0,15,4,11,0.267,65,0.231,2,0.238,14.3,118,14,104,0.119,205,0.576,10,0.605,6.6,133,18,115,0.135,263,0.506,12,0.53,7.5
172,1628492,Gian Clavell,1610612742,DAL,7,0,7,64.0,1,0,1,0.0,1,1.0,0,1.0,18.7,6,1,5,0.167,8,0.75,1,0.857,6.6,7,1,6,0.143,9,0.778,1,0.875,8.3
173,203507,Giannis Antetokounmpo,1610612749,MIL,74,39,35,2715.0,156,97,55,0.622,439,0.355,8,0.362,6.7,587,144,435,0.245,909,0.646,49,0.683,5.7,743,241,490,0.324,1273,0.584,57,0.611,5.9
174,203922,Glenn Robinson III,1610612754,IND,23,14,9,338.0,11,5,7,0.455,29,0.379,1,0.393,8.9,26,5,21,0.192,44,0.591,3,0.634,7.4,37,10,28,0.27,72,0.514,4,0.544,8.0
175,201609,Goran Dragic,1610612748,MIA,74,38,36,2349.0,54,27,26,0.5,209,0.258,9,0.27,11.1,245,33,212,0.135,480,0.51,42,0.559,9.1,299,60,238,0.201,677,0.442,51,0.478,9.4
176,202330,Gordon Hayward,1610612738,BOS,1,0,1,5.0,0,0,0,0.0,2,0.0,0,0.0,0.0,1,0,1,0.0,2,0.5,0,0.5,21.8,1,0,1,0.0,4,0.25,0,0.25,21.8
177,203476,Gorgui Dieng,1610612750,MIN,79,45,34,1333.0,106,59,47,0.557,211,0.502,2,0.507,7.7,254,79,174,0.311,434,0.585,23,0.618,5.3,360,138,221,0.383,620,0.581,25,0.605,6.0
178,202328,Greg Monroe,1610612738,BOS,50,21,29,1024.0,109,77,32,0.706,267,0.408,7,0.419,4.9,235,85,150,0.362,356,0.66,24,0.708,3.9,344,162,182,0.471,598,0.575,31,0.607,4.2
179,1627824,Guerschon Yabusele,1610612738,BOS,32,23,9,233.0,17,8,8,0.471,46,0.37,3,0.395,8.7,35,8,27,0.229,66,0.53,9,0.614,6.0,52,16,35,0.308,104,0.5,12,0.565,6.8
180,203084,Harrison Barnes,1610612742,DAL,77,24,53,2634.0,77,39,36,0.506,261,0.295,8,0.304,8.5,391,74,315,0.189,659,0.593,57,0.65,6.1,468,113,351,0.241,879,0.532,65,0.575,6.5
181,202355,Hassan Whiteside,1610612748,MIA,54,30,24,1364.0,174,118,55,0.678,407,0.428,7,0.435,4.8,444,164,279,0.369,669,0.664,41,0.707,3.5,618,282,334,0.456,1051,0.588,48,0.616,3.8
182,1627740,Henry Ellenson,1610612765,DET,38,21,17,329.0,10,6,4,0.6,31,0.323,0,0.323,6.6,71,18,51,0.254,121,0.587,9,0.634,5.4,81,24,55,0.296,148,0.547,9,0.583,5.5
183,203546,Ian Clark,1610612740,NOP,73,43,30,1428.0,10,1,9,0.1,58,0.172,5,0.189,13.1,116,13,100,0.112,195,0.595,19,0.659,9.2,126,14,109,0.111,250,0.504,24,0.558,9.5
184,101133,Ian Mahinmi,1610612764,WAS,77,42,35,1145.0,135,82,53,0.607,306,0.441,10,0.456,5.5,177,55,122,0.311,356,0.497,39,0.558,5.3,312,137,175,0.439,639,0.488,49,0.529,5.4
185,1628387,Ike Anigbogu,1610612754,IND,11,5,6,30.0,5,4,1,0.8,9,0.556,0,0.556,4.7,4,1,3,0.25,14,0.286,2,0.333,9.3,9,5,4,0.556,21,0.429,2,0.474,6.8
186,202697,Iman Shumpert,1610612758,SAC,14,9,5,276.0,7,0,6,0.0,22,0.318,0,0.318,19.7,34,6,29,0.176,52,0.654,3,0.694,6.7,41,6,35,0.146,72,0.569,3,0.594,8.6
187,203477,Isaiah Canaan,1610612756,PHX,20,9,11,422.0,6,4,2,0.667,34,0.176,2,0.188,7.7,39,5,34,0.128,75,0.52,4,0.549,7.3,45,9,36,0.2,107,0.421,6,0.446,7.4
188,1628439,Isaiah Hicks,1610612752,NYK,18,4,14,239.0,10,6,4,0.6,34,0.294,1,0.303,7.0,31,9,22,0.29,68,0.456,6,0.5,5.9,41,15,26,0.366,99,0.414,7,0.446,6.2
189,1627819,Isaiah Taylor,1610612737,ATL,67,18,49,1167.0,22,4,18,0.182,85,0.259,5,0.275,15.3,72,13,60,0.181,131,0.55,12,0.605,9.5,94,17,78,0.181,212,0.443,17,0.482,10.9
190,202738,Isaiah Thomas,1610612747,LAL,32,15,17,862.0,17,6,11,0.353,61,0.279,3,0.293,14.9,50,9,39,0.18,102,0.49,9,0.538,10.9,67,15,50,0.224,163,0.411,12,0.444,11.9
191,1627785,Isaiah Whitehead,1610612751,BKN,15,2,13,163.0,3,3,0,1.0,11,0.273,0,0.273,4.1,18,5,13,0.278,27,0.667,2,0.72,8.0,21,8,13,0.381,38,0.553,2,0.583,7.4
192,202397,Ish Smith,1610612765,DET,82,39,43,2043.0,27,6,21,0.222,159,0.17,1,0.171,11.2,197,33,161,0.168,406,0.485,45,0.546,8.6,224,39,182,0.174,561,0.399,46,0.435,8.9
193,1628397,Ivan Rabb,1610612763,MEM,36,6,30,516.0,53,44,8,0.83,132,0.402,4,0.414,5.8,105,39,67,0.371,177,0.593,10,0.629,5.2,158,83,75,0.525,293,0.539,14,0.566,5.4
194,1627826,Ivica Zubac,1610612747,LAL,43,19,24,410.0,45,30,13,0.667,93,0.484,3,0.5,4.1,78,30,44,0.385,140,0.557,12,0.609,4.0,123,60,57,0.488,231,0.532,15,0.569,4.0
195,200826,J.J. Barea,1610612742,DAL,69,23,46,1603.0,15,4,13,0.267,112,0.134,6,0.142,16.6,186,17,167,0.091,320,0.581,25,0.631,8.4,201,21,180,0.104,427,0.471,31,0.508,9.1
196,200755,JJ Redick,1610612755,PHI,69,45,24,2086.0,9,1,8,0.111,73,0.123,3,0.129,25.7,162,17,145,0.105,291,0.557,22,0.602,10.0,171,18,153,0.105,356,0.48,25,0.517,10.8
197,2747,JR Smith,1610612739,CLE,80,49,31,2244.0,29,14,15,0.483,103,0.282,5,0.296,13.8,206,33,171,0.16,347,0.594,28,0.646,8.5,235,47,186,0.2,432,0.544,33,0.589,9.1
198,203960,JaKarr Sampson,1610612758,SAC,22,6,16,344.0,21,12,8,0.571,57,0.368,2,0.382,5.6,57,7,50,0.123,102,0.559,8,0.606,4.5,78,19,58,0.244,155,0.503,10,0.538,4.8
199,203210,JaMychal Green,1610612763,MEM,55,11,44,1542.0,147,104,41,0.707,396,0.371,4,0.375,6.0,317,75,241,0.237,456,0.695,19,0.725,4.8,464,179,282,0.386,811,0.572,23,0.589,5.2
200,201580,JaVale McGee,1610612744,GSW,64,44,20,607.0,59,40,18,0.678,132,0.447,4,0.461,6.1,106,47,57,0.443,195,0.544,14,0.586,5.1,165,87,75,0.527,318,0.519,18,0.55,5.5
201,1628444,Jabari Bird,1610612738,BOS,13,8,5,115.0,6,2,4,0.333,13,0.462,2,0.545,5.5,13,1,11,0.077,19,0.684,1,0.722,7.7,19,3,15,0.158,32,0.594,3,0.655,7.0
202,203953,Jabari Parker,1610612749,MIL,31,16,15,743.0,42,22,20,0.524,116,0.362,1,0.365,9.4,109,18,90,0.165,197,0.553,12,0.589,6.5,151,40,110,0.265,295,0.512,13,0.535,7.3
203,204022,Jack Cooley,1610612758,SAC,7,4,3,87.0,14,10,3,0.714,41,0.341,0,0.341,3.3,16,4,12,0.25,28,0.571,1,0.593,6.3,30,14,15,0.467,67,0.448,1,0.455,5.0
204,1626643,Jacob Pullen,1610612755,PHI,3,2,1,6.0,0,0,0,0.0,0,0.0,0,0.0,0.0,0,0,0,0.0,0,0.0,0,0.0,0.0,0,0,0,0.0,0,0.0,0,0.0,0.0
205,1628451,Jacob Wiley,1610612751,BKN,4,1,3,32.0,2,1,1,0.5,5,0.4,0,0.4,4.0,9,0,9,0.0,13,0.692,1,0.75,3.3,11,1,10,0.091,17,0.647,1,0.688,3.4
206,203109,Jae Crowder,1610612762,UTA,80,52,28,2090.0,59,29,31,0.492,178,0.331,9,0.349,9.6,216,42,173,0.194,380,0.568,25,0.608,6.6,275,71,204,0.258,540,0.509,34,0.543,7.3
207,1626143,Jahlil Okafor,1610612751,BKN,28,7,21,353.0,21,15,6,0.714,69,0.304,2,0.313,4.8,64,24,39,0.375,105,0.61,8,0.66,4.5,85,39,45,0.459,165,0.515,10,0.548,4.6
208,1627774,Jake Layman,1610612757,POR,35,22,13,160.0,4,3,1,0.75,12,0.333,1,0.364,5.7,12,2,10,0.167,19,0.632,3,0.75,6.6,16,5,11,0.313,28,0.571,4,0.667,6.4
209,1627751,Jakob Poeltl,1610612761,TOR,82,59,23,1524.0,165,125,41,0.758,389,0.424,5,0.43,6.0,228,113,113,0.496,501,0.455,47,0.502,4.0,393,238,154,0.606,867,0.453,52,0.482,4.9
210,1627883,Jalen Jones,1610612742,DAL,16,3,13,181.0,13,7,6,0.538,36,0.361,3,0.394,8.9,25,3,22,0.12,38,0.658,2,0.694,5.6,38,10,28,0.263,68,0.559,5,0.603,6.7
211,2037,Jamal Crawford,1610612750,MIN,80,45,35,1653.0,21,5,15,0.238,51,0.412,3,0.438,17.9,78,3,74,0.038,134,0.582,8,0.619,11.6,99,8,89,0.081,183,0.541,11,0.576,12.9
212,1627750,Jamal Murray,1610612743,DEN,81,46,35,2565.0,82,36,47,0.439,258,0.318,9,0.329,10.4,215,37,174,0.172,415,0.518,33,0.563,7.8,297,73,221,0.246,665,0.447,42,0.477,8.6
213,1627866,Jameel Warney,1610612742,DAL,3,1,2,27.0,4,4,0,1.0,13,0.308,0,0.308,2.6,5,1,4,0.2,6,0.833,0,0.833,5.1,9,5,4,0.556,19,0.474,0,0.474,4.0
214,2749,Jameer Nelson,1610612765,DET,49,24,25,995.0,13,3,9,0.231,55,0.236,1,0.241,16.7,90,11,79,0.122,150,0.6,17,0.677,8.2,103,14,88,0.136,201,0.512,18,0.563,9.2
215,1628503,Jamel Artis,1610612753,ORL,15,4,11,279.0,4,2,2,0.5,20,0.2,1,0.211,8.6,34,9,23,0.265,58,0.586,5,0.642,6.9,38,11,25,0.289,76,0.5,6,0.543,7.1
216,203516,James Ennis III,1610612765,DET,71,24,47,1567.0,71,37,35,0.521,193,0.368,5,0.378,11.0,142,36,105,0.254,266,0.534,17,0.57,5.6,213,73,140,0.343,445,0.479,22,0.504,7.4
217,201935,James Harden,1610612745,HOU,71,59,12,2516.0,40,19,21,0.475,252,0.159,9,0.165,9.1,344,47,296,0.137,559,0.615,38,0.66,7.4,384,66,317,0.172,773,0.497,47,0.529,7.6
218,201949,James Johnson,1610612748,MIA,72,36,36,1912.0,60,24,35,0.4,207,0.29,6,0.299,11.5,291,61,228,0.21,514,0.566,30,0.601,5.4,351,85,263,0.242,683,0.514,36,0.543,6.4
219,203949,James Michael McAdoo,1610612755,PHI,3,1,2,18.0,0,0,0,0.0,1,0.0,0,0.0,0.0,2,1,1,0.5,2,1.0,0,1.0,6.8,2,1,1,0.5,3,0.667,0,0.667,6.8
220,1627821,James Webb III,1610612751,BKN,10,1,9,120.0,8,4,4,0.5,16,0.5,2,0.571,7.8,16,1,15,0.063,25,0.64,5,0.8,5.0,24,5,19,0.208,40,0.6,7,0.727,5.9
221,203923,James Young,1610612755,PHI,6,4,2,61.0,0,0,0,0.0,1,0.0,0,0.0,0.0,2,0,2,0.0,4,0.5,0,0.5,9.4,2,0,2,0.0,5,0.4,0,0.4,9.4
222,203966,Jamil Wilson,1610612746,LAC,15,6,9,274.0,3,2,1,0.667,15,0.2,0,0.2,15.4,29,7,21,0.241,68,0.426,5,0.46,6.4,32,9,22,0.281,81,0.395,5,0.421,7.3
223,201162,Jared Dudley,1610612756,PHX,48,7,41,686.0,8,5,3,0.625,42,0.19,3,0.205,7.5,86,16,68,0.186,181,0.475,14,0.515,7.1,94,21,71,0.223,216,0.435,17,0.472,7.1
224,204067,Jarell Eddie,1610612741,CHI,3,1,2,9.0,0,0,0,0.0,0,0.0,0,0.0,0.0,1,1,0,1.0,1,1.0,0,1.0,2.8,1,1,0,1.0,1,1.0,0,1.0,2.8
225,1626185,Jarell Martin,1610612763,MEM,72,20,52,1640.0,96,65,31,0.677,303,0.317,7,0.324,7.1,217,52,164,0.24,438,0.495,35,0.538,5.0,313,117,195,0.374,712,0.44,42,0.467,5.7
226,1628386,Jarrett Allen,1610612751,BKN,70,24,46,1401.0,142,98,42,0.69,341,0.416,8,0.426,5.7,236,63,173,0.267,459,0.514,36,0.558,4.9,378,161,215,0.426,765,0.494,44,0.524,5.2
227,101127,Jarrett Jack,1610612752,NYK,61,25,36,1513.0,20,2,19,0.1,65,0.308,1,0.313,15.7,163,11,152,0.067,260,0.627,14,0.663,9.9,183,13,171,0.071,322,0.568,15,0.596,10.6
228,201160,Jason Smith,1610612764,WAS,33,15,18,285.0,18,8,9,0.444,43,0.419,0,0.419,8.1,35,14,21,0.4,65,0.538,5,0.583,4.9,53,22,30,0.415,100,0.53,5,0.558,6.0
229,1891,Jason Terry,1610612749,MIL,51,27,24,814.0,5,0,5,0.0,20,0.25,1,0.263,19.4,43,6,37,0.14,70,0.614,5,0.662,11.0,48,6,42,0.125,90,0.533,6,0.571,11.8
230,1628393,Jawun Evans,1610612746,LAC,48,24,24,778.0,9,3,8,0.333,54,0.167,2,0.173,13.2,75,18,57,0.24,155,0.484,19,0.551,7.4,84,21,65,0.25,205,0.41,21,0.457,8.2
231,1627759,Jaylen Brown,1610612738,BOS,67,44,23,2050.0,60,32,31,0.533,238,0.252,6,0.259,9.0,269,60,209,0.223,434,0.62,26,0.659,6.2,329,92,240,0.28,652,0.505,32,0.531,6.7
232,1628537,Jaylen Morris,1610612737,ATL,6,2,4,98.0,2,0,3,0.0,14,0.143,0,0.143,4.2,14,2,11,0.143,25,0.56,1,0.583,8.8,16,2,14,0.125,38,0.421,1,0.432,8.6
233,1628369,Jayson Tatum,1610612738,BOS,77,50,27,2362.0,49,26,22,0.531,196,0.25,6,0.258,9.5,340,63,277,0.185,546,0.623,29,0.658,6.5,389,89,299,0.229,725,0.537,35,0.564,6.9
234,201145,Jeff Green,1610612739,CLE,78,47,31,1828.0,60,38,22,0.633,165,0.364,5,0.375,8.3,186,67,119,0.36,352,0.528,19,0.559,6.4,246,105,141,0.427,505,0.487,24,0.511,6.8
235,201952,Jeff Teague,1610612750,MIN,70,41,29,2311.0,24,3,21,0.125,135,0.178,3,0.182,16.1,185,17,167,0.092,349,0.53,26,0.573,9.7,209,20,188,0.096,480,0.435,29,0.463,10.4
236,203481,Jeff Withey,1610612742,DAL,10,2,8,39.0,1,1,0,1.0,5,0.2,0,0.2,2.5,9,3,6,0.333,16,0.563,1,0.6,4.4,10,4,6,0.4,19,0.526,1,0.556,4.2
237,203924,Jerami Grant,1610612760,OKC,79,48,31,1606.0,84,50,31,0.595,240,0.35,8,0.362,7.5,231,74,157,0.32,414,0.558,25,0.594,5.9,315,124,188,0.394,632,0.498,33,0.526,6.3
238,202379,Jeremy Evans,1610612737,ATL,1,0,1,5.0,1,0,1,0.0,1,1.0,0,1.0,5.6,0,0,0,0.0,0,0.0,0,0.0,0.0,1,0,1,0.0,1,1.0,0,1.0,5.6
239,203087,Jeremy Lamb,1610612766,CHA,80,36,44,1967.0,49,24,25,0.49,159,0.308,6,0.32,12.3,275,46,229,0.167,448,0.614,36,0.667,5.8,324,70,254,0.216,601,0.539,42,0.58,6.9
240,202391,Jeremy Lin,1610612751,BKN,1,0,1,25.0,0,0,0,0.0,0,0.0,0,0.0,0.0,0,0,0,0.0,0,0.0,1,0.0,0.0,0,0,0,0.0,0,0.0,1,0.0,0.0
241,1626170,Jerian Grant,1610612741,CHI,74,24,50,1686.0,31,11,20,0.355,134,0.231,3,0.237,14.7,140,17,126,0.121,276,0.507,27,0.562,7.5,171,28,146,0.164,403,0.424,30,0.458,8.8
242,201573,Jerryd Bayless,1610612755,PHI,38,21,17,908.0,15,3,12,0.2,69,0.217,6,0.238,17.7,64,6,59,0.094,121,0.529,11,0.582,12.1,79,9,71,0.114,182,0.434,17,0.479,13.1
243,202710,Jimmy Butler,1610612750,MIN,59,37,22,2164.0,79,34,45,0.43,236,0.335,12,0.353,10.1,235,59,173,0.251,401,0.586,38,0.647,7.7,314,93,218,0.296,629,0.499,50,0.542,8.3
244,201149,Joakim Noah,1610612752,NYK,7,1,6,40.0,6,4,2,0.667,10,0.6,0,0.6,3.8,8,3,5,0.375,15,0.533,2,0.615,2.8,14,7,7,0.5,25,0.56,2,0.609,3.3
245,201975,Jodie Meeks,1610612764,WAS,77,41,36,1119.0,15,6,10,0.4,41,0.366,1,0.375,15.2,111,13,95,0.117,174,0.638,20,0.721,8.9,126,19,105,0.151,213,0.592,21,0.656,9.8
246,203925,Joe Harris,1610612751,BKN,77,26,51,1948.0,50,26,26,0.52,193,0.259,7,0.269,11.8,205,44,161,0.215,390,0.526,31,0.571,7.4,255,70,187,0.275,580,0.44,38,0.47,8.3
247,204060,Joe Ingles,1610612762,UTA,82,48,34,2578.0,24,7,19,0.292,95,0.253,1,0.255,12.2,320,41,277,0.128,489,0.654,27,0.693,8.2,344,48,296,0.14,573,0.6,28,0.631,8.6
248,2207,Joe Johnson,1610612745,HOU,55,35,20,1205.0,14,9,5,0.643,56,0.25,0,0.25,10.0,158,26,130,0.165,271,0.583,17,0.622,6.4,172,35,135,0.203,305,0.564,17,0.597,6.7
249,1626202,Joe Young,1610612754,IND,53,28,25,558.0,12,2,10,0.167,41,0.293,3,0.316,15.0,51,4,48,0.078,78,0.654,6,0.708,11.0,63,6,58,0.095,114,0.553,9,0.6,11.7
250,1627762,Joel Bolomboy,1610612749,MIL,6,3,3,38.0,6,4,2,0.667,9,0.667,0,0.667,6.5,4,0,4,0.0,6,0.667,1,0.8,4.5,10,4,6,0.4,14,0.714,1,0.769,5.7
251,203954,Joel Embiid,1610612755,PHI,62,41,21,1882.0,143,100,42,0.699,392,0.365,9,0.373,6.3,537,198,339,0.369,874,0.614,57,0.657,3.7,680,298,381,0.438,1215,0.56,66,0.592,4.3
252,203530,Joffrey Lauvergne,1610612759,SAS,55,30,25,534.0,63,42,22,0.667,165,0.382,3,0.389,5.3,108,28,79,0.259,167,0.647,11,0.692,4.1,171,70,101,0.409,318,0.538,14,0.563,4.5
253,1628381,John Collins,1610612737,ATL,73,21,52,1760.0,173,115,56,0.665,508,0.341,8,0.346,6.1,361,124,239,0.343,697,0.518,63,0.569,4.0,534,239,295,0.448,1160,0.46,71,0.49,4.7
254,203089,John Henson,1610612749,MIL,75,39,36,1953.0,150,107,41,0.713,351,0.427,6,0.435,4.9,360,137,223,0.381,633,0.569,32,0.599,4.3,510,244,264,0.478,945,0.54,38,0.562,4.5
255,204066,John Holland,1610612739,CLE,24,17,7,174.0,6,3,3,0.5,12,0.5,0,0.5,14.0,18,4,14,0.222,36,0.5,2,0.529,8.2,24,7,17,0.292,45,0.533,2,0.558,9.7
256,202322,John Wall,1610612764,WAS,41,23,18,1410.0,22,1,20,0.045,126,0.175,9,0.188,22.8,128,9,117,0.07,243,0.527,20,0.574,9.3,150,10,137,0.067,366,0.41,29,0.445,11.3
257,1628405,Johnathan Motley,1610612742,DAL,11,1,10,176.0,14,10,4,0.714,39,0.359,1,0.368,6.8,35,7,28,0.2,59,0.593,3,0.625,5.0,49,17,32,0.347,93,0.527,4,0.551,5.5
258,203948,Johnny O'Bryant III,1610612766,CHA,36,15,21,379.0,29,22,8,0.759,83,0.349,1,0.354,4.9,64,15,49,0.234,126,0.508,12,0.561,5.1,93,37,57,0.398,204,0.456,13,0.487,5.0
259,202720,Jon Leuer,1610612765,DET,8,5,3,136.0,7,4,3,0.571,16,0.438,0,0.438,6.6,25,8,17,0.32,59,0.424,5,0.463,4.3,32,12,20,0.375,74,0.432,5,0.464,4.8
260,201973,Jonas Jerebko,1610612762,UTA,74,45,29,1133.0,53,24,28,0.453,148,0.358,5,0.371,8.9,193,36,156,0.187,355,0.544,24,0.583,4.9,246,60,184,0.244,482,0.51,29,0.543,5.8
261,202685,Jonas Valanciunas,1610612761,TOR,77,56,21,1727.0,183,134,46,0.732,474,0.386,9,0.394,5.2,477,161,312,0.338,796,0.599,53,0.642,3.5,660,295,358,0.447,1227,0.538,62,0.567,3.9
262,1626780,Jonathan Gibson,1610612738,BOS,4,2,2,40.0,0,0,0,0.0,0,0.0,0,0.0,0.0,3,1,2,0.333,7,0.429,0,0.429,8.8,3,1,2,0.333,7,0.429,0,0.429,8.8
263,1628371,Jonathan Isaac,1610612753,ORL,27,11,16,535.0,16,11,5,0.688,57,0.281,1,0.286,5.4,83,30,52,0.361,164,0.506,12,0.546,4.3,99,41,57,0.414,213,0.465,13,0.495,4.5
264,203613,Jonathon Simmons,1610612753,ORL,69,21,48,2029.0,61,37,27,0.607,186,0.328,10,0.347,9.8,178,29,142,0.163,317,0.562,18,0.595,8.2,239,66,169,0.276,499,0.479,28,0.507,8.6
265,1628395,Jordan Bell,1610612744,GSW,56,42,14,804.0,59,35,24,0.593,147,0.401,3,0.41,7.3,146,44,97,0.301,259,0.564,21,0.613,5.2,205,79,121,0.385,389,0.527,24,0.562,5.8
266,203903,Jordan Clarkson,1610612739,CLE,81,40,41,1887.0,57,26,32,0.456,175,0.326,7,0.339,9.1,160,24,136,0.15,310,0.516,23,0.557,8.3,217,50,168,0.23,475,0.457,30,0.488,8.6
267,202348,Jordan Crawford,1610612740,NOP,4,3,1,29.0,1,0,1,0.0,1,1.0,0,1.0,25.5,1,1,0,1.0,3,0.333,0,0.333,8.0,2,1,1,0.5,4,0.5,0,0.5,16.7
268,1626175,Jordan Mickey,1610612748,MIA,23,15,8,284.0,18,12,5,0.667,66,0.273,2,0.281,8.1,63,22,41,0.349,122,0.516,15,0.589,3.8,81,34,46,0.42,180,0.45,17,0.497,4.7
269,101181,Jose Calderon,1610612739,CLE,57,33,24,914.0,14,6,8,0.429,40,0.35,1,0.359,13.2,70,6,64,0.086,130,0.538,17,0.619,8.8,84,12,72,0.143,169,0.497,18,0.556,9.5
270,1627982,Josh Gray,1610612756,PHX,5,0,5,86.0,2,0,2,0.0,6,0.333,1,0.4,17.6,8,2,6,0.25,14,0.571,0,0.571,6.4,10,2,8,0.2,20,0.5,1,0.526,8.7
271,1628404,Josh Hart,1610612747,LAL,63,27,36,1461.0,42,23,21,0.548,129,0.326,6,0.341,10.2,221,54,167,0.244,378,0.585,32,0.639,6.7,263,77,188,0.293,499,0.527,38,0.57,7.4
272,203962,Josh Huestis,1610612760,OKC,67,43,24,966.0,41,15,26,0.366,98,0.418,2,0.427,9.4,118,29,90,0.246,235,0.502,19,0.546,6.2,159,44,116,0.277,323,0.492,21,0.526,7.0
273,1628367,Josh Jackson,1610612756,PHX,77,19,58,1959.0,95,51,45,0.537,303,0.314,7,0.321,9.4,256,48,209,0.188,435,0.589,33,0.637,6.9,351,99,254,0.282,727,0.483,40,0.511,7.6
274,203705,Josh Magette,1610612737,ATL,18,3,15,216.0,2,0,2,0.0,3,0.667,0,0.667,28.2,17,3,14,0.176,34,0.5,2,0.531,10.2,19,3,16,0.158,37,0.514,2,0.543,12.1
275,201177,Josh McRoberts,1610612742,DAL,2,2,0,6.0,0,0,0,0.0,0,0.0,0,0.0,0.0,0,0,0,0.0,0,0.0,0,0.0,0.0,0,0,0,0.0,0,0.0,0,0.0,0.0
276,1626196,Josh Richardson,1610612748,MIA,80,43,37,2657.0,68,29,37,0.426,233,0.292,9,0.304,11.6,211,28,183,0.133,422,0.5,31,0.54,9.0,279,57,220,0.204,640,0.436,40,0.465,9.6
277,2746,Josh Smith,1610612740,NOP,3,2,1,12.0,3,0,3,0.0,4,0.75,1,1.0,2.7,1,1,0,1.0,2,0.5,0,0.5,2.0,4,1,3,0.25,6,0.667,1,0.8,2.5
278,201950,Jrue Holiday,1610612740,NOP,79,46,33,2859.0,60,28,31,0.467,235,0.255,9,0.265,10.0,294,58,238,0.197,545,0.539,39,0.581,8.6,354,86,269,0.243,771,0.459,48,0.49,8.8
279,1627823,Juancho Hernangomez,1610612743,DEN,25,15,10,277.0,18,12,4,0.667,34,0.529,0,0.529,7.9,36,12,22,0.333,65,0.554,7,0.621,4.5,54,24,26,0.444,97,0.557,7,0.6,5.6
280,203944,Julius Randle,1610612747,LAL,82,35,47,2190.0,181,127,53,0.702,520,0.348,13,0.357,5.8,473,130,335,0.275,767,0.617,47,0.657,5.2,654,257,388,0.393,1223,0.535,60,0.562,5.4
281,202933,Julyan Stone,1610612766,CHA,23,10,13,175.0,1,0,1,0.0,6,0.167,0,0.167,22.3,28,4,24,0.143,37,0.757,1,0.778,6.1,29,4,25,0.138,42,0.69,1,0.707,6.7
282,1626147,Justin Anderson,1610612755,PHI,37,27,10,515.0,25,16,9,0.64,67,0.373,1,0.379,7.2,67,16,51,0.239,120,0.558,12,0.62,7.0,92,32,60,0.348,178,0.517,13,0.558,7.1
283,203200,Justin Holiday,1610612741,CHI,72,24,48,2265.0,31,15,16,0.484,109,0.284,3,0.292,10.2,260,36,224,0.138,440,0.591,34,0.64,7.2,291,51,240,0.175,543,0.536,37,0.575,7.5
284,1628382,Justin Jackson,1610612758,SAC,68,21,47,1506.0,27,12,15,0.444,101,0.267,3,0.276,8.7,160,27,131,0.169,244,0.656,10,0.684,7.3,187,39,146,0.209,331,0.565,13,0.588,7.5
285,1628383,Justin Patton,1610612750,MIN,1,0,1,4.0,0,0,0,0.0,0,0.0,0,0.0,0.0,0,0,0,0.0,0,0.0,0,0.0,0.0,0,0,0,0.0,0,0.0,0,0.0,0.0
286,1626159,Justise Winslow,1610612748,MIA,67,32,35,1655.0,63,36,27,0.571,245,0.257,5,0.263,8.7,301,97,202,0.322,549,0.548,51,0.604,5.4,364,133,229,0.365,774,0.47,56,0.507,6.0
287,203994,Jusuf Nurkic,1610612757,POR,79,48,31,2088.0,189,144,41,0.762,530,0.357,7,0.361,5.4,519,187,329,0.36,910,0.57,73,0.62,3.9,708,331,370,0.468,1409,0.502,80,0.533,4.3
288,1628443,Kadeem Allen,1610612738,BOS,18,9,9,107.0,4,2,2,0.5,11,0.364,0,0.364,4.6,7,1,6,0.143,15,0.467,1,0.5,7.8,11,3,8,0.273,26,0.423,1,0.44,6.6
289,1626157,Karl-Anthony Towns,1610612750,MIN,82,47,35,2918.0,238,160,78,0.672,605,0.393,15,0.403,6.2,774,291,482,0.376,1224,0.632,70,0.671,4.4,1012,451,560,0.446,1751,0.578,85,0.607,4.8
290,202695,Kawhi Leonard,1610612759,SAS,9,5,4,210.0,6,5,1,0.833,22,0.273,1,0.286,2.5,36,9,27,0.25,56,0.643,2,0.667,8.2,42,14,28,0.333,72,0.583,3,0.609,7.4
291,1627770,Kay Felder,1610612765,DET,16,6,10,140.0,3,1,2,0.333,12,0.25,0,0.25,10.1,15,2,13,0.133,19,0.789,0,0.789,9.9,18,3,15,0.167,31,0.581,0,0.581,9.9
292,203482,Kelly Olynyk,1610612748,MIA,75,41,34,1751.0,87,60,26,0.69,270,0.322,6,0.33,6.1,339,114,225,0.336,588,0.577,37,0.615,4.9,426,174,251,0.408,815,0.523,43,0.552,5.1
293,1626162,Kelly Oubre Jr.,1610612764,WAS,81,43,38,2231.0,59,34,25,0.576,272,0.217,14,0.229,8.1,304,78,222,0.257,501,0.607,28,0.643,5.3,363,112,247,0.309,740,0.491,42,0.52,5.7
294,202689,Kemba Walker,1610612766,CHA,80,36,44,2736.0,32,10,23,0.313,207,0.155,13,0.165,10.5,216,23,194,0.106,456,0.474,54,0.537,9.6,248,33,217,0.133,657,0.377,67,0.42,9.8
295,2570,Kendrick Perkins,1610612739,CLE,1,0,1,15.0,0,0,0,0.0,2,0.0,0,0.0,0.0,1,0,1,0.0,3,0.333,1,0.5,3.7,1,0,1,0.0,5,0.2,1,0.25,3.7
296,202702,Kenneth Faried,1610612743,DEN,32,16,16,461.0,68,49,18,0.721,163,0.417,1,0.42,4.8,85,31,56,0.365,139,0.612,5,0.634,5.1,153,80,74,0.523,291,0.526,6,0.537,4.9
297,203145,Kent Bazemore,1610612737,ATL,64,19,45,1759.0,25,8,18,0.32,159,0.157,3,0.16,13.2,220,41,178,0.186,397,0.554,44,0.623,6.7,245,49,196,0.2,547,0.448,47,0.49,7.4
298,203484,Kentavious Caldwell-Pope,1610612747,LAL,74,31,43,2458.0,60,31,29,0.517,176,0.341,4,0.349,8.1,327,53,265,0.162,537,0.609,41,0.659,7.1,387,84,294,0.217,705,0.549,45,0.586,7.3
299,201142,Kevin Durant,1610612744,GSW,67,48,19,2287.0,31,15,19,0.484,150,0.207,7,0.217,11.9,425,115,307,0.271,664,0.64,35,0.676,6.2,456,130,326,0.285,779,0.585,42,0.619,6.6
300,201567,Kevin Love,1610612739,CLE,59,37,22,1651.0,101,73,25,0.723,294,0.344,7,0.352,6.2,445,142,297,0.319,665,0.669,32,0.703,4.4,546,215,322,0.394,921,0.593,39,0.619,4.7
301,1626172,Kevon Looney,1610612744,GSW,66,45,21,910.0,83,58,22,0.699,188,0.441,1,0.444,6.1,132,55,75,0.417,262,0.504,16,0.537,6.0,215,113,97,0.526,433,0.497,17,0.517,6.0
302,203920,Khem Birch,1610612753,ORL,42,14,28,578.0,70,46,22,0.657,145,0.483,3,0.493,5.4,110,36,73,0.327,176,0.625,9,0.659,4.7,180,82,95,0.456,308,0.584,12,0.608,5.0
303,203114,Khris Middleton,1610612749,MIL,81,44,37,2947.0,44,21,26,0.477,197,0.223,6,0.23,12.1,383,80,298,0.209,635,0.603,42,0.646,6.9,427,101,324,0.237,794,0.538,48,0.572,7.4
304,202691,Klay Thompson,1610612744,GSW,72,54,18,2468.0,29,17,12,0.586,106,0.274,3,0.282,10.2,244,62,183,0.254,443,0.551,35,0.598,7.6,273,79,195,0.289,544,0.502,38,0.54,7.9
305,1628424,Kobi Simmons,1610612763,MEM,32,6,26,643.0,14,7,7,0.5,50,0.28,1,0.286,11.4,36,2,34,0.056,62,0.581,5,0.632,9.1,50,9,41,0.18,111,0.45,6,0.476,9.8
306,201585,Kosta Koufos,1610612758,SAC,71,22,49,1391.0,149,82,64,0.55,315,0.473,3,0.478,6.3,323,104,216,0.322,489,0.661,24,0.695,4.1,472,186,280,0.394,772,0.611,27,0.634,4.8
307,1627739,Kris Dunn,1610612741,CHI,52,19,33,1525.0,24,5,20,0.208,136,0.176,4,0.182,13.7,197,31,165,0.157,372,0.53,46,0.604,6.8,221,36,185,0.163,503,0.439,50,0.488,7.6
308,204001,Kristaps Porzingis,1610612752,NYK,48,22,26,1553.0,62,37,24,0.597,180,0.344,3,0.35,9.2,254,76,180,0.299,447,0.568,24,0.6,4.9,316,113,204,0.358,604,0.523,27,0.548,5.7
309,203937,Kyle Anderson,1610612759,SAS,74,41,33,1978.0,84,55,27,0.655,223,0.377,8,0.391,6.5,312,64,247,0.205,457,0.683,27,0.726,6.3,396,119,274,0.301,650,0.609,35,0.644,6.3
310,1627858,Kyle Collinsworth,1610612742,DAL,32,9,23,480.0,32,19,12,0.594,87,0.368,5,0.39,6.4,75,12,63,0.16,128,0.586,5,0.61,5.5,107,31,75,0.29,210,0.51,10,0.535,5.7
311,2594,Kyle Korver,1610612739,CLE,73,43,30,1574.0,9,2,7,0.222,42,0.214,4,0.237,17.8,156,36,119,0.231,300,0.52,28,0.574,7.7,165,38,126,0.23,338,0.488,32,0.539,8.3
312,1628398,Kyle Kuzma,1610612747,LAL,77,34,43,2401.0,88,54,32,0.614,283,0.311,8,0.32,8.2,395,94,295,0.238,672,0.588,54,0.639,5.2,483,148,327,0.306,912,0.53,62,0.568,5.8
313,200768,Kyle Lowry,1610612761,TOR,78,57,21,2510.0,66,35,31,0.53,279,0.237,14,0.249,11.7,368,56,314,0.152,657,0.56,57,0.613,7.7,434,91,345,0.21,927,0.468,71,0.507,8.3
314,203124,Kyle O'Quinn,1610612752,NYK,76,27,49,1362.0,120,79,39,0.658,331,0.363,7,0.37,5.6,343,133,209,0.388,579,0.592,34,0.629,4.1,463,212,248,0.458,864,0.536,41,0.563,4.5
315,202713,Kyle Singler,1610612760,OKC,11,5,6,36.0,1,1,0,1.0,5,0.2,1,0.25,7.1,6,0,6,0.0,8,0.75,0,0.75,6.9,7,1,6,0.143,13,0.538,1,0.583,7.0
316,202681,Kyrie Irving,1610612738,BOS,57,38,19,1834.0,32,16,17,0.5,135,0.237,6,0.248,9.1,182,27,154,0.148,369,0.493,34,0.543,8.9,214,43,171,0.201,502,0.426,40,0.463,8.9
317,200746,LaMarcus Aldridge,1610612759,SAS,75,45,30,2509.0,246,169,73,0.687,538,0.457,7,0.463,5.3,389,126,262,0.324,654,0.595,49,0.643,6.3,635,295,335,0.465,1162,0.546,56,0.574,5.9
318,202362,Lance Stephenson,1610612754,IND,82,48,34,1850.0,62,33,28,0.532,256,0.242,8,0.25,8.7,362,57,301,0.157,532,0.68,25,0.714,5.5,424,90,329,0.212,749,0.566,33,0.592,6.0
319,202498,Lance Thomas,1610612752,NYK,72,24,48,1328.0,44,23,20,0.523,133,0.331,4,0.341,7.2,129,26,103,0.202,234,0.551,17,0.594,8.7,173,49,123,0.283,354,0.489,21,0.52,8.3
320,204038,Langston Galloway,1610612765,DET,58,28,30,863.0,13,2,12,0.154,51,0.255,1,0.26,14.0,79,7,72,0.089,141,0.56,11,0.608,9.5,92,9,84,0.098,189,0.487,12,0.52,10.3
321,203580,Larry Drew II,1610612740,NOP,10,6,4,70.0,3,1,2,0.333,6,0.5,1,0.6,9.2,0,0,0,0.0,2,0.0,1,0.0,0.0,3,1,2,0.333,8,0.375,2,0.5,9.2
322,1626204,Larry Nance Jr.,1610612739,CLE,66,32,34,1421.0,161,102,56,0.634,351,0.459,11,0.474,6.0,291,90,201,0.309,486,0.599,28,0.635,5.5,452,192,257,0.425,810,0.558,39,0.586,5.7
323,1628374,Lauri Markkanen,1610612741,CHI,68,23,45,2020.0,79,45,31,0.57,221,0.357,5,0.366,5.7,429,102,327,0.238,634,0.677,32,0.713,5.4,508,147,358,0.289,817,0.622,37,0.651,5.4
324,2544,LeBron James,1610612739,CLE,82,50,32,3026.0,97,46,53,0.474,336,0.289,13,0.3,7.9,612,125,484,0.204,902,0.678,34,0.705,5.7,709,171,537,0.241,1186,0.598,47,0.622,6.0
325,1628506,London Perrantes,1610612739,CLE,14,8,6,66.0,1,1,0,1.0,5,0.2,1,0.25,5.6,3,1,2,0.333,5,0.6,2,1.0,9.6,4,2,2,0.5,10,0.4,3,0.571,8.6
326,1628366,Lonzo Ball,1610612747,LAL,52,24,28,1780.0,69,35,31,0.507,230,0.3,8,0.311,8.1,291,52,236,0.179,445,0.654,24,0.691,6.9,360,87,267,0.242,661,0.545,32,0.572,7.1
327,203485,Lorenzo Brown,1610612761,TOR,14,9,5,139.0,1,0,1,0.0,3,0.333,0,0.333,10.1,14,5,8,0.357,17,0.824,3,1.0,6.5,15,5,9,0.333,20,0.75,3,0.882,6.7
328,101150,Lou Williams,1610612746,LAC,79,42,37,2589.0,40,18,24,0.45,193,0.207,7,0.215,10.7,158,21,135,0.133,285,0.554,16,0.587,11.1,198,39,159,0.197,473,0.419,23,0.44,11.1
329,201601,Luc Mbah a Moute,1610612745,HOU,60,52,8,1536.0,22,3,19,0.136,116,0.19,7,0.202,13.5,162,64,97,0.395,319,0.508,45,0.591,7.2,184,67,116,0.364,428,0.43,52,0.489,8.0
330,203512,Lucas Nogueira,1610612761,TOR,49,36,13,418.0,18,15,4,0.833,44,0.409,1,0.419,4.2,69,20,49,0.29,123,0.561,13,0.627,5.1,87,35,53,0.402,164,0.53,14,0.58,4.9
331,1626242,Luis Montero,1610612765,DET,2,1,1,8.0,0,0,0,0.0,2,0.0,0,0.0,0.0,2,2,0,1.0,3,0.667,1,1.0,3.3,2,2,0,1.0,5,0.4,1,0.5,3.3
332,202337,Luke Babbitt,1610612748,MIA,49,15,34,690.0,7,0,7,0.0,32,0.219,2,0.233,18.5,87,23,63,0.264,173,0.503,13,0.544,6.1,94,23,70,0.245,194,0.485,15,0.525,7.0
333,1628379,Luke Kennard,1610612765,DET,73,34,39,1463.0,21,8,11,0.381,70,0.3,1,0.304,12.8,155,25,131,0.161,276,0.562,22,0.61,8.6,176,33,142,0.188,341,0.516,23,0.553,9.1
334,1628436,Luke Kornet,1610612752,NYK,20,6,14,326.0,11,9,2,0.818,40,0.275,0,0.275,3.5,53,21,32,0.396,120,0.442,9,0.477,5.5,64,30,34,0.469,154,0.416,9,0.441,5.2
335,2736,Luol Deng,1610612747,LAL,1,0,1,13.0,0,0,0,0.0,0,0.0,0,0.0,0.0,0,0,0,0.0,0,0.0,1,0.0,0.0,0,0,0,0.0,0,0.0,1,0.0,0.0
336,1627781,Malachi Richardson,1610612761,TOR,26,8,18,323.0,5,2,3,0.4,20,0.25,0,0.25,17.8,29,7,22,0.241,42,0.69,4,0.763,5.1,34,9,25,0.265,60,0.567,4,0.607,7.0
337,1627763,Malcolm Brogdon,1610612749,MIL,47,25,22,1400.0,23,8,16,0.348,97,0.237,4,0.247,12.3,127,25,103,0.197,243,0.523,20,0.57,7.5,150,33,119,0.22,334,0.449,24,0.484,8.4
338,1627098,Malcolm Delaney,1610612737,ATL,53,16,37,989.0,9,4,5,0.444,55,0.164,6,0.184,11.8,90,15,74,0.167,168,0.536,12,0.577,8.7,99,19,79,0.192,220,0.45,18,0.49,9.0
339,1626259,Malcolm Miller,1610612761,TOR,15,15,0,126.0,4,2,2,0.5,15,0.267,2,0.308,12.9,11,2,9,0.182,18,0.611,2,0.688,8.5,15,4,11,0.267,32,0.469,4,0.536,9.7
340,1627736,Malik Beasley,1610612743,DEN,62,34,28,583.0,14,6,8,0.429,31,0.452,0,0.452,12.7,57,11,46,0.193,91,0.626,4,0.655,7.8,71,17,54,0.239,122,0.582,4,0.602,8.8
341,1628370,Malik Monk,1610612766,CHA,63,26,37,853.0,8,2,6,0.25,32,0.25,0,0.25,13.0,58,8,50,0.138,98,0.592,6,0.63,9.5,66,10,56,0.152,129,0.512,6,0.537,9.9
342,1628493,Mangok Mathiang,1610612766,CHA,4,3,1,20.0,3,2,1,0.667,11,0.273,0,0.273,12.9,7,2,5,0.286,10,0.7,2,0.875,4.6,10,4,6,0.4,19,0.526,2,0.588,7.1
343,1938,Manu Ginobili,1610612759,SAS,65,39,26,1299.0,19,8,11,0.421,98,0.194,5,0.204,8.5,123,31,91,0.252,236,0.521,16,0.559,7.3,142,39,102,0.275,326,0.436,21,0.466,7.4
344,202705,MarShon Brooks,1610612763,MEM,7,2,5,193.0,8,2,6,0.25,28,0.286,2,0.308,20.0,13,0,13,0.0,24,0.542,2,0.591,7.7,21,2,19,0.095,51,0.412,4,0.447,12.4
345,201188,Marc Gasol,1610612763,MEM,72,20,52,2371.0,78,41,37,0.526,256,0.305,8,0.315,10.0,509,169,336,0.332,827,0.615,49,0.654,4.5,587,210,373,0.358,1029,0.57,57,0.604,5.2
346,101162,Marcin Gortat,1610612764,WAS,82,43,39,2074.0,181,108,72,0.597,496,0.365,14,0.376,6.6,442,102,334,0.231,791,0.559,75,0.617,4.2,623,210,406,0.337,1238,0.503,89,0.542,4.9
347,201158,Marco Belinelli,1610612755,PHI,79,39,40,1921.0,20,3,16,0.15,129,0.155,5,0.161,18.4,127,17,109,0.134,243,0.523,19,0.567,8.1,147,20,125,0.136,363,0.405,24,0.434,9.5
348,1627875,Marcus Georges-Hunt,1610612750,MIN,42,24,18,224.0,7,2,5,0.286,12,0.583,1,0.636,11.5,9,2,7,0.222,13,0.692,3,0.9,8.6,16,4,12,0.25,25,0.64,4,0.762,9.9
349,202694,Marcus Morris,1610612738,BOS,52,32,20,1394.0,38,24,15,0.632,151,0.252,6,0.262,9.3,239,53,184,0.222,408,0.586,23,0.621,5.5,277,77,199,0.278,536,0.517,29,0.546,6.1
350,1627779,Marcus Paige,1610612766,CHA,5,4,1,28.0,0,0,0,0.0,0,0.0,0,0.0,0.0,4,0,4,0.0,4,1.0,0,1.0,9.6,4,0,4,0.0,4,1.0,0,1.0,9.6
351,203935,Marcus Smart,1610612738,BOS,51,35,16,1537.0,42,21,21,0.5,163,0.258,5,0.266,10.1,140,35,106,0.25,271,0.517,20,0.558,7.9,182,56,127,0.308,425,0.428,25,0.455,8.4
352,201596,Mario Chalmers,1610612763,MEM,65,20,45,1396.0,13,5,8,0.385,117,0.111,2,0.113,15.0,143,18,125,0.126,262,0.546,22,0.596,9.2,156,23,133,0.147,371,0.42,24,0.45,9.7
353,1626209,Mario Hezonja,1610612753,ORL,75,21,54,1657.0,41,19,23,0.463,164,0.25,6,0.259,13.0,240,51,184,0.213,383,0.627,19,0.659,5.7,281,70,207,0.249,524,0.536,25,0.563,6.8
354,203900,Markel Brown,1610612745,HOU,4,4,0,31.0,1,0,1,0.0,5,0.2,0,0.2,21.1,4,1,3,0.25,8,0.5,0,0.5,5.5,5,1,4,0.2,13,0.385,0,0.385,8.6
355,1628365,Markelle Fultz,1610612755,PHI,14,11,3,253.0,11,5,6,0.455,40,0.275,1,0.282,7.5,32,5,27,0.156,60,0.533,3,0.561,7.8,43,10,33,0.233,98,0.439,4,0.457,7.7
356,202693,Markieff Morris,1610612764,WAS,73,37,36,1968.0,75,48,28,0.64,239,0.314,9,0.326,6.8,334,93,240,0.278,538,0.621,27,0.654,5.8,409,141,268,0.345,753,0.543,36,0.57,6.0
357,1627737,Marquese Chriss,1610612756,PHX,72,19,53,1527.0,76,51,25,0.671,244,0.311,3,0.315,6.2,319,97,220,0.304,539,0.592,37,0.635,4.4,395,148,245,0.375,732,0.54,40,0.571,4.8
358,203104,Marquis Teague,1610612763,MEM,3,0,3,74.0,1,0,1,0.0,3,0.333,0,0.333,25.2,5,0,5,0.0,11,0.455,0,0.455,10.7,6,0,6,0.0,13,0.462,0,0.462,13.1
359,201578,Marreese Speights,1610612753,ORL,52,15,37,675.0,21,14,7,0.667,73,0.288,0,0.288,7.0,112,39,71,0.348,217,0.516,18,0.563,4.9,133,53,78,0.398,282,0.472,18,0.504,5.3
360,1627850,Marshall Plumlee,1610612749,MIL,8,5,3,52.0,4,3,1,0.75,17,0.235,2,0.267,5.2,13,6,7,0.462,19,0.684,0,0.684,4.4,17,9,8,0.529,35,0.486,2,0.515,4.5
361,101107,Marvin Williams,1610612766,CHA,78,33,45,2006.0,74,51,23,0.689,183,0.404,11,0.43,8.3,296,57,236,0.193,488,0.607,33,0.651,7.0,370,108,259,0.292,657,0.563,44,0.604,7.3
362,203486,Mason Plumlee,1610612743,DEN,74,40,34,1439.0,132,88,39,0.667,368,0.359,9,0.368,5.4,268,79,184,0.295,448,0.598,28,0.638,4.6,400,167,223,0.418,799,0.501,37,0.525,4.9
363,1627856,Matt Costello,1610612759,SAS,4,2,2,32.0,1,1,0,1.0,4,0.25,0,0.25,2.1,8,4,3,0.5,12,0.667,1,0.727,5.0,9,5,3,0.556,15,0.6,1,0.643,4.7
364,1628475,Matt Williams Jr.,1610612748,MIA,3,1,2,11.0,0,0,0,0.0,0,0.0,0,0.0,0.0,1,0,1,0.0,2,0.5,0,0.5,3.7,1,0,1,0.0,2,0.5,0,0.5,3.7
365,203521,Matthew Dellavedova,1610612749,MIL,37,21,16,691.0,14,2,13,0.143,43,0.326,3,0.35,14.8,48,9,38,0.188,103,0.466,12,0.527,8.8,62,11,51,0.177,145,0.428,15,0.477,10.3
366,203090,Maurice Harkless,1610612757,POR,59,36,23,1264.0,46,29,17,0.63,153,0.301,4,0.309,7.6,116,34,83,0.293,213,0.545,17,0.592,6.4,162,63,100,0.389,351,0.462,21,0.491,6.7
367,1628467,Maxi Kleber,1610612742,DAL,72,20,52,1206.0,71,39,30,0.549,178,0.399,5,0.41,7.8,163,56,108,0.344,293,0.556,22,0.601,5.2,234,95,138,0.406,452,0.518,27,0.551,6.0
368,203086,Meyers Leonard,1610612757,POR,33,17,16,254.0,12,10,1,0.833,33,0.364,1,0.375,6.3,58,16,42,0.276,83,0.699,6,0.753,4.7,70,26,43,0.371,109,0.642,7,0.686,4.9
369,201563,Michael Beasley,1610612752,NYK,73,23,50,1616.0,97,63,31,0.649,233,0.416,9,0.433,6.1,312,90,218,0.288,500,0.624,25,0.657,4.5,409,153,249,0.374,703,0.582,34,0.611,4.8
370,203487,Michael Carter-Williams,1610612766,CHA,52,23,29,835.0,37,15,23,0.405,111,0.333,2,0.339,11.1,101,14,87,0.139,186,0.543,14,0.587,7.5,138,29,110,0.21,292,0.473,16,0.5,8.4
371,203077,Michael Kidd-Gilchrist,1610612766,CHA,74,34,40,1850.0,84,46,37,0.548,244,0.344,9,0.357,8.0,218,45,173,0.206,403,0.541,35,0.592,8.3,302,91,210,0.301,640,0.472,44,0.507,8.2
372,201144,Mike Conley,1610612763,MEM,11,6,5,345.0,0,0,0,0.0,10,0.0,1,0.0,0.0,24,1,23,0.042,47,0.511,7,0.6,11.1,24,1,23,0.042,56,0.429,8,0.5,11.1
373,1628455,Mike James,1610612740,NOP,36,11,25,686.0,13,4,9,0.308,58,0.224,2,0.232,8.9,77,7,70,0.091,156,0.494,14,0.542,9.8,90,11,79,0.122,212,0.425,16,0.459,9.7
374,203488,Mike Muscala,1610612737,ATL,53,14,39,1060.0,56,39,16,0.696,139,0.403,1,0.406,7.1,174,67,105,0.385,314,0.554,20,0.592,5.2,230,106,121,0.461,439,0.524,21,0.55,5.6
375,203118,Mike Scott,1610612764,WAS,76,39,37,1406.0,50,26,22,0.52,154,0.325,7,0.34,5.9,197,47,148,0.239,323,0.61,16,0.642,6.1,247,73,170,0.296,455,0.543,23,0.572,6.1
376,203101,Miles Plumlee,1610612737,ATL,55,19,36,918.0,77,45,31,0.584,211,0.365,9,0.381,7.2,151,49,102,0.325,309,0.489,44,0.57,4.9,228,94,133,0.412,508,0.449,53,0.501,5.7
377,1628462,Milos Teodosic,1610612746,LAC,45,29,16,1134.0,16,4,11,0.25,71,0.225,3,0.235,14.1,110,15,95,0.136,239,0.46,20,0.502,8.3,126,19,106,0.151,310,0.406,23,0.439,9.0
378,1628495,Milton Doyle,1610612751,BKN,10,2,8,125.0,3,1,2,0.333,12,0.25,0,0.25,18.5,15,1,14,0.067,28,0.536,5,0.652,6.8,18,2,16,0.111,40,0.45,5,0.514,8.7
379,1627851,Mindaugas Kuzminskas,1610612752,NYK,1,0,1,2.0,0,0,0,0.0,0,0.0,0,0.0,0.0,0,0,0,0.0,0,0.0,1,0.0,0.0,0,0,0,0.0,0,0.0,1,0.0,0.0
380,203141,Mirza Teletovic,1610612749,MIL,9,4,5,142.0,3,1,2,0.333,7,0.429,0,0.429,8.1,17,1,16,0.059,35,0.486,1,0.5,4.8,20,2,18,0.1,42,0.476,1,0.488,5.3
381,1628420,Monte Morris,1610612743,DEN,3,2,1,25.0,0,0,0,0.0,2,0.0,1,0.0,0.0,2,0,2,0.0,2,1.0,0,1.0,16.7,2,0,2,0.0,4,0.5,1,0.667,16.7
382,1626149,Montrezl Harrell,1610612746,LAC,76,39,37,1293.0,103,74,29,0.718,257,0.401,6,0.41,6.3,203,72,130,0.355,366,0.555,24,0.594,5.8,306,146,159,0.477,597,0.513,30,0.54,5.9
383,1627988,Myke Henry,1610612763,MEM,20,3,17,378.0,10,4,6,0.4,38,0.263,1,0.27,15.4,28,7,21,0.25,62,0.452,11,0.549,7.1,38,11,27,0.289,96,0.396,12,0.452,9.3
384,1626167,Myles Turner,1610612754,IND,65,39,26,1836.0,93,62,32,0.667,242,0.384,9,0.399,6.2,324,129,193,0.398,645,0.502,48,0.543,4.4,417,191,225,0.458,858,0.486,57,0.521,4.8
385,203489,Nate Wolters,1610612762,UTA,5,3,2,19.0,1,0,1,0.0,1,1.0,0,1.0,13.4,1,0,0,0.0,1,1.0,0,1.0,0.0,2,0,1,0.0,2,1.0,0,1.0,13.4
386,1628513,Naz Mitrou-Long,1610612762,UTA,1,0,1,1.0,0,0,0,0.0,0,0.0,0,0.0,0.0,0,0,0,0.0,0,0.0,0,0.0,0.0,0,0,0,0.0,0,0.0,0,0.0,0.0
387,202357,Nemanja Bjelica,1610612750,MIN,67,38,29,1371.0,53,35,17,0.66,141,0.376,2,0.381,6.2,221,67,153,0.303,361,0.612,26,0.66,5.8,274,102,170,0.372,486,0.564,28,0.598,5.9
388,2403,Nene,1610612745,HOU,51,42,9,743.0,53,36,17,0.679,155,0.342,2,0.346,5.8,120,34,85,0.283,215,0.558,19,0.612,4.8,173,70,102,0.405,361,0.479,21,0.509,5.1
389,203457,Nerlens Noel,1610612742,DAL,30,6,24,472.0,48,38,9,0.792,127,0.378,3,0.387,4.9,120,41,78,0.342,191,0.628,19,0.698,3.9,168,79,87,0.47,307,0.547,22,0.589,4.2
390,2555,Nick Collison,1610612760,OKC,13,9,4,58.0,5,3,2,0.6,16,0.313,1,0.333,4.1,11,0,10,0.0,19,0.579,1,0.611,4.6,16,3,12,0.188,33,0.485,2,0.516,4.4
391,201156,Nick Young,1610612744,GSW,79,55,24,1382.0,20,5,16,0.25,58,0.345,2,0.357,14.5,104,21,83,0.202,191,0.545,15,0.591,8.9,124,26,99,0.21,246,0.504,17,0.541,10.1
392,201587,Nicolas Batum,1610612766,CHA,64,27,37,1981.0,57,30,27,0.526,162,0.352,4,0.361,8.6,249,42,207,0.169,385,0.647,31,0.703,6.8,306,72,234,0.235,533,0.574,35,0.614,7.1
393,1627852,Nicolas Brussino,1610612737,ATL,4,0,4,10.0,0,0,0,0.0,0,0.0,0,0.0,0.0,3,0,3,0.0,3,1.0,0,1.0,7.0,3,0,3,0.0,3,1.0,0,1.0,7.0
394,1628502,Nigel Hayes,1610612758,SAC,9,6,3,122.0,4,2,2,0.5,15,0.267,0,0.267,11.2,18,6,12,0.333,24,0.75,0,0.75,7.0,22,8,14,0.364,35,0.629,0,0.629,7.7
395,203917,Nik Stauskas,1610612751,BKN,41,14,27,523.0,4,1,3,0.25,24,0.167,0,0.167,8.9,60,7,53,0.117,94,0.638,7,0.69,7.0,64,8,56,0.125,116,0.552,7,0.587,7.1
396,203999,Nikola Jokic,1610612743,DEN,75,43,32,2443.0,195,147,40,0.754,438,0.445,8,0.453,5.5,608,200,405,0.329,938,0.648,47,0.682,4.2,803,347,445,0.432,1312,0.612,55,0.639,4.5
397,202703,Nikola Mirotic,1610612740,NOP,55,34,21,1494.0,59,39,18,0.661,177,0.333,6,0.345,6.2,346,81,263,0.234,531,0.652,29,0.689,5.2,405,120,281,0.296,661,0.613,35,0.647,5.4
398,202696,Nikola Vucevic,1610612753,ORL,57,17,40,1683.0,101,66,32,0.653,244,0.414,2,0.417,7.1,422,157,262,0.372,620,0.681,36,0.723,3.9,523,223,294,0.426,830,0.63,38,0.66,4.5
399,203943,Noah Vonleh,1610612741,CHI,54,24,30,876.0,70,51,18,0.729,181,0.387,3,0.393,5.9,241,81,159,0.336,368,0.655,16,0.685,3.8,311,132,177,0.424,535,0.581,19,0.603,4.3
400,1626181,Norman Powell,1610612761,TOR,70,51,19,1062.0,14,6,7,0.429,66,0.212,6,0.233,16.2,105,20,83,0.19,173,0.607,15,0.665,6.3,119,26,90,0.218,230,0.517,21,0.569,7.4
401,1628384,OG Anunoby,1610612761,TOR,74,51,23,1481.0,44,21,23,0.477,121,0.364,3,0.373,9.1,140,32,105,0.229,219,0.639,20,0.704,6.3,184,53,128,0.288,330,0.558,23,0.599,7.0
402,1627855,Okaro White,1610612739,CLE,6,2,4,80.0,3,2,1,0.667,9,0.333,1,0.375,6.8,8,3,5,0.375,17,0.471,1,0.5,5.7,11,5,6,0.455,26,0.423,2,0.458,6.0
403,204179,Omari Johnson,1610612763,MEM,4,1,3,75.0,4,3,1,0.75,8,0.5,1,0.571,6.0,7,1,6,0.143,20,0.35,2,0.389,8.3,11,4,7,0.364,28,0.393,3,0.44,7.5
404,201600,Omer Asik,1610612741,CHI,18,7,11,182.0,9,5,4,0.556,20,0.45,0,0.45,5.8,38,10,28,0.263,68,0.559,9,0.644,4.5,47,15,32,0.319,85,0.553,9,0.618,4.8
405,201956,Omri Casspi,1610612744,GSW,53,40,13,742.0,30,21,10,0.7,106,0.283,4,0.294,3.8,170,29,140,0.171,285,0.596,22,0.646,4.6,200,50,150,0.25,374,0.535,26,0.575,4.5
406,203490,Otto Porter Jr.,1610612764,WAS,77,42,35,2432.0,103,61,41,0.592,323,0.319,15,0.334,8.8,389,92,294,0.237,638,0.61,34,0.644,6.6,492,153,335,0.311,932,0.528,49,0.557,7.0
407,1628408,PJ Dozier,1610612760,OKC,2,1,1,3.0,0,0,0,0.0,0,0.0,0,0.0,0.0,1,0,1,0.0,1,1.0,0,1.0,6.6,1,0,1,0.0,1,1.0,0,1.0,6.6
408,200782,PJ Tucker,1610612745,HOU,81,65,16,2253.0,90,53,36,0.589,273,0.33,3,0.333,8.4,359,91,267,0.253,607,0.591,44,0.638,6.1,449,144,303,0.321,839,0.535,47,0.567,6.6
409,1627783,Pascal Siakam,1610612761,TOR,81,59,22,1679.0,79,44,35,0.557,234,0.338,8,0.35,8.3,285,88,197,0.309,500,0.57,27,0.603,5.7,364,132,232,0.363,693,0.525,35,0.553,6.3
410,1626192,Pat Connaughton,1610612757,POR,82,49,33,1488.0,36,15,22,0.417,111,0.324,6,0.343,13.1,125,20,105,0.16,218,0.573,27,0.654,8.1,161,35,127,0.217,321,0.502,33,0.559,9.2
411,201976,Patrick Beverley,1610612746,LAC,11,5,6,334.0,16,4,12,0.25,48,0.333,3,0.356,11.6,29,6,22,0.207,51,0.569,1,0.58,7.6,45,10,34,0.222,98,0.459,4,0.479,9.1
412,1627775,Patrick McCaw,1610612744,GSW,57,41,16,961.0,16,3,14,0.188,63,0.254,2,0.262,13.2,66,12,54,0.182,122,0.541,6,0.569,7.9,82,15,68,0.183,182,0.451,8,0.471,9.0
413,202335,Patrick Patterson,1610612760,OKC,79,48,31,1212.0,31,17,15,0.548,91,0.341,3,0.352,9.7,155,49,106,0.316,288,0.538,20,0.578,5.8,186,66,121,0.355,372,0.5,23,0.533,6.4
414,201988,Patty Mills,1610612759,SAS,82,47,35,2107.0,26,7,19,0.269,104,0.25,4,0.26,15.8,128,11,117,0.086,227,0.564,18,0.612,11.6,154,18,136,0.117,329,0.468,22,0.502,12.3
415,2200,Pau Gasol,1610612759,SAS,77,45,32,1812.0,129,88,40,0.682,343,0.376,8,0.385,6.3,490,163,328,0.333,757,0.647,44,0.687,4.0,619,251,368,0.405,1057,0.586,52,0.616,4.5
416,202331,Paul George,1610612760,OKC,77,47,30,2818.0,67,28,39,0.418,276,0.243,8,0.25,14.6,366,72,294,0.197,649,0.564,54,0.615,7.0,433,100,333,0.231,905,0.478,62,0.514,8.2
417,200794,Paul Millsap,1610612743,DEN,38,22,16,1143.0,65,38,25,0.585,145,0.448,2,0.455,7.6,180,60,113,0.333,336,0.536,28,0.584,5.6,245,98,138,0.4,470,0.521,30,0.557,6.1
418,1627835,Paul Zipser,1610612741,CHI,54,17,37,824.0,13,8,5,0.615,71,0.183,2,0.188,9.4,118,28,89,0.237,203,0.581,18,0.638,5.0,131,36,94,0.275,262,0.5,20,0.541,5.4
419,203112,Quincy Acy,1610612751,BKN,68,25,43,1323.0,39,11,28,0.282,123,0.317,3,0.325,11.2,214,46,166,0.215,400,0.535,29,0.577,5.1,253,57,194,0.225,497,0.509,32,0.544,6.0
420,202347,Quincy Pondexter,1610612741,CHI,23,6,17,196.0,8,6,2,0.75,21,0.381,0,0.381,7.2,19,2,17,0.105,38,0.5,6,0.594,7.9,27,8,19,0.296,57,0.474,6,0.529,7.7
421,1626188,Quinn Cook,1610612744,GSW,33,21,12,741.0,10,2,8,0.2,56,0.179,1,0.182,25.1,72,9,63,0.125,150,0.48,13,0.526,8.0,82,11,71,0.134,203,0.404,14,0.434,10.1
422,1626154,RJ Hunter,1610612745,HOU,5,3,2,45.0,0,0,0,0.0,2,0.0,0,0.0,0.0,5,1,4,0.2,6,0.833,2,1.25,7.8,5,1,4,0.2,8,0.625,2,0.833,7.8
423,200765,Rajon Rondo,1610612740,NOP,64,40,24,1674.0,31,12,19,0.387,166,0.187,5,0.193,11.0,230,25,204,0.109,406,0.567,22,0.599,8.4,261,37,223,0.142,563,0.464,27,0.487,8.7
424,201196,Ramon Sessions,1610612764,WAS,28,10,18,392.0,6,1,5,0.167,16,0.375,1,0.4,14.8,32,0,32,0.0,57,0.561,3,0.593,9.3,38,1,37,0.026,72,0.528,4,0.559,10.2
425,1626173,Rashad Vaughn,1610612753,ORL,28,13,15,212.0,3,1,2,0.333,5,0.6,0,0.6,18.4,18,4,14,0.222,36,0.5,3,0.545,8.3,21,5,16,0.238,41,0.512,3,0.553,9.8
426,203526,Raul Neto,1610612762,UTA,41,28,13,498.0,7,1,6,0.143,38,0.184,1,0.189,14.4,42,2,40,0.048,84,0.5,9,0.56,9.9,49,3,46,0.061,122,0.402,10,0.438,10.6
427,101109,Raymond Felton,1610612760,OKC,79,48,31,1312.0,24,7,14,0.292,93,0.258,5,0.273,11.5,126,22,103,0.175,220,0.573,24,0.643,8.9,150,29,117,0.193,309,0.485,29,0.536,9.3
428,203493,Reggie Bullock,1610612765,DET,62,32,30,1732.0,27,14,14,0.519,94,0.287,5,0.303,11.1,127,30,97,0.236,225,0.564,18,0.614,8.8,154,44,111,0.286,313,0.492,23,0.531,9.2
429,203687,Reggie Hearn,1610612765,DET,3,3,0,7.0,0,0,0,0.0,0,0.0,0,0.0,0.0,0,0,0,0.0,0,0.0,0,0.0,0.0,0,0,0,0.0,0,0.0,0,0.0,0.0
430,202704,Reggie Jackson,1610612765,DET,45,27,18,1201.0,29,11,18,0.379,114,0.254,7,0.271,12.9,96,11,85,0.115,186,0.516,25,0.596,8.7,125,22,103,0.176,299,0.418,32,0.468,9.7
431,2210,Richard Jefferson,1610612743,DEN,20,10,10,163.0,2,1,1,0.5,14,0.143,0,0.143,2.1,15,3,12,0.2,29,0.517,5,0.625,6.9,17,4,13,0.235,39,0.436,5,0.5,6.4
432,1626158,Richaun Holmes,1610612755,PHI,47,30,17,728.0,57,36,21,0.632,170,0.335,5,0.345,8.7,150,53,96,0.353,268,0.56,17,0.598,4.5,207,89,117,0.43,421,0.492,22,0.519,5.7
433,201937,Ricky Rubio,1610612762,UTA,77,44,33,2254.0,44,12,32,0.273,208,0.212,2,0.214,14.3,307,43,262,0.14,502,0.612,40,0.665,8.6,351,55,294,0.157,702,0.5,42,0.532,9.3
434,203496,Robert Covington,1610612755,PHI,79,51,28,2501.0,54,23,31,0.426,195,0.277,10,0.292,11.2,376,96,279,0.255,699,0.538,60,0.588,6.9,430,119,310,0.277,875,0.491,70,0.534,7.4
435,201577,Robin Lopez,1610612741,CHI,64,23,41,1690.0,134,96,34,0.716,354,0.379,6,0.385,5.0,156,61,95,0.391,346,0.451,57,0.54,5.8,290,157,129,0.541,687,0.422,63,0.465,5.4
436,203918,Rodney Hood,1610612739,CLE,60,29,31,1615.0,22,5,17,0.227,92,0.239,2,0.244,13.7,143,16,126,0.112,256,0.559,20,0.606,8.6,165,21,143,0.127,335,0.493,22,0.527,9.3
437,203585,Rodney McGruder,1610612748,MIA,18,11,7,299.0,11,4,7,0.364,34,0.324,1,0.333,7.4,22,1,20,0.045,47,0.468,3,0.5,6.2,33,5,27,0.152,81,0.407,4,0.429,6.6
438,1628681,Rodney Purvis,1610612753,ORL,16,5,11,290.0,1,0,1,0.0,11,0.091,0,0.091,12.4,26,3,22,0.115,45,0.578,1,0.591,6.8,27,3,23,0.111,56,0.482,1,0.491,7.0
439,1627758,Ron Baker,1610612752,NYK,28,11,17,367.0,5,1,4,0.2,16,0.313,1,0.333,16.9,24,4,20,0.167,49,0.49,2,0.511,9.9,29,5,24,0.172,64,0.453,3,0.475,11.1
440,1626178,Rondae Hollis-Jefferson,1610612751,BKN,66,25,41,1851.0,99,64,35,0.646,321,0.308,9,0.317,6.2,348,106,239,0.305,618,0.563,53,0.616,4.9,447,170,274,0.38,891,0.502,62,0.539,5.2
441,1626220,Royce O'Neale,1610612762,UTA,69,43,26,1150.0,25,10,16,0.4,82,0.305,2,0.313,8.4,211,64,144,0.303,328,0.643,25,0.696,5.3,236,74,160,0.314,399,0.591,27,0.634,5.7
442,200752,Rudy Gay,1610612759,SAS,57,36,21,1231.0,76,42,30,0.553,186,0.409,5,0.42,7.3,215,59,156,0.274,397,0.542,33,0.591,5.1,291,101,186,0.347,562,0.518,38,0.555,5.7
443,203497,Rudy Gobert,1610612762,UTA,56,37,19,1816.0,165,113,51,0.685,452,0.365,8,0.372,5.1,436,127,304,0.291,772,0.565,61,0.613,3.8,601,240,355,0.399,1187,0.506,69,0.538,4.1
444,201566,Russell Westbrook,1610612760,OKC,77,47,30,2804.0,147,69,79,0.469,537,0.274,25,0.287,10.1,626,98,531,0.157,893,0.701,35,0.73,6.7,773,167,610,0.216,1349,0.573,60,0.6,7.3
445,201583,Ryan Anderson,1610612745,HOU,65,52,13,1694.0,91,61,30,0.67,226,0.403,6,0.414,7.2,234,81,153,0.346,403,0.581,27,0.622,5.7,325,142,183,0.437,611,0.532,33,0.562,6.1
446,1627853,Ryan Arcidiacono,1610612741,CHI,24,6,18,304.0,1,0,1,0.0,12,0.083,0,0.083,10.6,24,2,22,0.083,35,0.686,2,0.727,8.3,25,2,23,0.08,45,0.556,2,0.581,8.4
447,1626257,Salah Mejri,1610612742,DAL,61,21,40,729.0,85,61,24,0.718,208,0.409,3,0.415,6.8,161,60,100,0.373,287,0.561,23,0.61,4.1,246,121,124,0.492,476,0.517,26,0.547,5.1
448,1626155,Sam Dekker,1610612746,LAC,73,36,37,883.0,44,28,16,0.636,132,0.333,4,0.344,7.6,130,30,101,0.231,235,0.553,21,0.607,5.8,174,58,117,0.333,352,0.494,25,0.532,6.3
449,203816,Scotty Hopson,1610612742,DAL,1,0,1,8.0,0,0,0,0.0,0,0.0,0,0.0,0.0,0,0,0,0.0,0,0.0,0,0.0,0.0,0,0,0,0.0,0,0.0,0,0.0,0.0
450,203930,Sean Kilpatrick,1610612741,CHI,52,22,30,640.0,5,1,4,0.2,41,0.122,4,0.135,13.6,82,9,73,0.11,123,0.667,12,0.739,7.6,87,10,77,0.115,161,0.54,16,0.6,8.0
451,1628400,Semi Ojeleye,1610612738,BOS,70,47,23,1132.0,36,13,23,0.361,97,0.371,2,0.379,12.4,124,44,79,0.355,225,0.551,18,0.599,7.0,160,57,102,0.356,304,0.526,20,0.563,8.2
452,201586,Serge Ibaka,1610612761,TOR,76,53,23,2093.0,78,51,28,0.654,252,0.31,6,0.317,6.1,400,104,293,0.26,689,0.581,54,0.63,4.2,478,155,321,0.324,902,0.53,60,0.568,4.6
453,203498,Shabazz Muhammad,1610612749,MIL,43,25,18,418.0,23,19,4,0.826,72,0.319,2,0.329,5.5,53,15,38,0.283,79,0.671,4,0.707,4.4,76,34,42,0.447,144,0.528,6,0.551,4.7
454,203894,Shabazz Napier,1610612757,POR,74,46,28,1535.0,26,8,18,0.308,122,0.213,1,0.215,14.3,144,12,131,0.083,288,0.5,34,0.567,8.5,170,20,149,0.118,406,0.419,35,0.458,9.4
455,203499,Shane Larkin,1610612738,BOS,51,36,15,743.0,15,5,10,0.333,52,0.288,4,0.313,11.3,75,11,64,0.147,126,0.595,9,0.641,8.4,90,16,74,0.178,177,0.508,13,0.549,8.9
456,1627885,Shaquille Harrison,1610612756,PHX,23,3,20,384.0,9,3,6,0.333,53,0.17,1,0.173,9.1,52,10,42,0.192,86,0.605,5,0.642,8.9,61,13,48,0.213,139,0.439,6,0.459,9.0
457,2733,Shaun Livingston,1610612744,GSW,70,48,22,1115.0,30,9,21,0.3,78,0.385,5,0.411,10.5,96,22,74,0.229,184,0.522,16,0.571,8.5,126,31,95,0.246,259,0.486,21,0.529,9.1
458,202714,Shelvin Mack,1610612753,ORL,69,21,48,1365.0,23,3,23,0.13,86,0.267,5,0.284,12.5,143,15,125,0.105,253,0.565,19,0.611,9.4,166,18,148,0.108,329,0.505,24,0.544,9.9
459,1628414,Sindarius Thornwell,1610612746,LAC,73,36,37,1156.0,33,9,23,0.273,107,0.308,2,0.314,10.7,107,33,75,0.308,204,0.525,24,0.594,7.4,140,42,98,0.3,307,0.456,26,0.498,8.2
460,1627746,Skal Labissiere,1610612758,SAC,60,19,41,1240.0,98,68,29,0.694,244,0.402,6,0.412,5.9,189,58,127,0.307,355,0.532,33,0.587,5.4,287,126,156,0.439,584,0.491,39,0.527,5.6
461,203524,Solomon Hill,1610612740,NOP,12,8,4,187.0,9,4,5,0.444,22,0.409,2,0.45,5.3,27,5,22,0.185,45,0.6,3,0.643,8.4,36,9,27,0.25,65,0.554,5,0.6,7.6
462,203915,Spencer Dinwiddie,1610612751,BKN,78,27,51,2255.0,39,13,26,0.333,144,0.271,3,0.277,14.5,213,28,184,0.131,354,0.602,20,0.638,8.3,252,41,210,0.163,484,0.521,23,0.547,9.3
463,1626169,Stanley Johnson,1610612765,DET,69,33,36,1893.0,33,21,13,0.636,132,0.25,3,0.256,9.6,219,42,176,0.192,392,0.559,33,0.61,7.4,252,63,189,0.25,515,0.489,36,0.526,7.7
464,201939,Stephen Curry,1610612744,GSW,50,40,10,1596.0,36,11,25,0.306,147,0.245,4,0.252,13.2,222,37,185,0.167,401,0.554,33,0.603,8.4,258,48,210,0.186,544,0.474,37,0.509,9.1
465,1628425,Sterling Brown,1610612749,MIL,54,26,28,776.0,27,11,16,0.407,62,0.435,2,0.45,13.2,116,22,91,0.19,192,0.604,20,0.674,5.9,143,33,107,0.231,251,0.57,22,0.624,7.3
466,203500,Steven Adams,1610612760,OKC,74,43,31,2431.0,373,261,104,0.7,794,0.47,19,0.481,5.3,295,109,186,0.369,593,0.497,49,0.542,5.4,668,370,290,0.554,1367,0.489,68,0.514,5.4
467,204456,T.J. McConnell,1610612755,PHI,75,50,25,1680.0,37,13,26,0.351,131,0.282,4,0.291,14.4,185,21,161,0.114,306,0.605,19,0.645,9.1,222,34,187,0.153,425,0.522,23,0.552,10.0
468,203933,T.J. Warren,1610612756,PHX,65,18,47,2142.0,125,87,39,0.696,321,0.389,8,0.399,6.3,208,66,139,0.317,362,0.575,21,0.61,8.3,333,153,178,0.459,659,0.505,29,0.529,7.6
469,1628388,TJ Leaf,1610612754,IND,53,31,22,459.0,29,16,13,0.552,73,0.397,2,0.408,7.5,53,13,36,0.245,97,0.546,10,0.609,5.7,82,29,49,0.354,167,0.491,12,0.529,6.4
470,201959,Taj Gibson,1610612750,MIN,82,47,35,2726.0,194,132,62,0.68,511,0.38,17,0.393,6.6,390,98,291,0.251,717,0.544,44,0.579,5.6,584,230,353,0.394,1187,0.492,61,0.519,5.9
471,204028,Tarik Black,1610612745,HOU,51,40,11,536.0,63,44,18,0.698,152,0.414,2,0.42,5.4,100,32,67,0.32,171,0.585,14,0.637,5.1,163,76,85,0.466,306,0.533,16,0.562,5.2
472,1627752,Taurean Prince,1610612737,ATL,81,24,57,2431.0,49,16,34,0.327,181,0.271,6,0.28,13.1,335,71,263,0.212,567,0.591,49,0.647,6.4,384,87,297,0.227,734,0.523,55,0.566,7.3
473,1628390,Terrance Ferguson,1610612760,OKC,59,37,22,742.0,19,8,12,0.421,33,0.576,3,0.633,14.6,28,8,19,0.286,63,0.444,5,0.483,9.9,47,16,31,0.34,96,0.49,8,0.534,12.3
474,203082,Terrence Ross,1610612753,ORL,24,10,14,600.0,10,2,8,0.2,40,0.25,1,0.256,16.4,63,9,52,0.143,107,0.589,7,0.63,8.0,73,11,60,0.151,143,0.51,8,0.541,9.2
475,1626179,Terry Rozier,1610612738,BOS,77,51,26,2001.0,61,30,32,0.492,186,0.328,7,0.341,10.5,299,55,244,0.184,526,0.568,47,0.624,7.2,360,85,276,0.236,706,0.51,54,0.552,7.7
476,200757,Thabo Sefolosha,1610612762,UTA,38,16,22,806.0,29,11,17,0.379,90,0.322,4,0.337,10.8,132,37,95,0.28,216,0.611,16,0.66,5.9,161,48,112,0.298,294,0.548,20,0.588,6.7
477,201152,Thaddeus Young,1610612754,IND,81,48,33,2607.0,184,119,65,0.647,447,0.412,5,0.416,5.3,328,88,241,0.268,587,0.559,43,0.603,6.6,512,207,306,0.404,1008,0.508,48,0.533,6.2
478,1628418,Thomas Bryant,1610612747,LAL,15,7,8,72.0,3,1,2,0.333,9,0.333,1,0.375,10.4,14,6,8,0.429,20,0.7,1,0.737,4.5,17,7,10,0.412,26,0.654,2,0.708,5.5
479,1627748,Thon Maker,1610612749,MIL,73,40,33,1224.0,74,42,31,0.568,195,0.379,3,0.385,7.3,148,48,100,0.324,336,0.44,35,0.492,6.2,222,90,131,0.405,509,0.436,38,0.471,6.6
480,204025,Tim Frazier,1610612764,WAS,59,31,28,838.0,18,6,12,0.333,69,0.261,1,0.265,13.2,97,11,85,0.113,178,0.545,24,0.63,8.8,115,17,97,0.148,240,0.479,25,0.535,9.5
481,203501,Tim Hardaway Jr.,1610612752,NYK,57,19,38,1885.0,32,14,19,0.438,180,0.178,5,0.183,13.1,192,21,167,0.109,340,0.565,27,0.613,8.3,224,35,186,0.156,505,0.444,32,0.474,9.0
482,1627817,Tim Quarterman,1610612745,HOU,3,2,1,13.0,0,0,0,0.0,1,0.0,0,0.0,0.0,3,2,1,0.667,3,1.0,0,1.0,6.1,3,2,1,0.667,4,0.75,0,0.75,6.1
483,202389,Timofey Mozgov,1610612751,BKN,29,11,18,346.0,31,20,11,0.645,71,0.437,1,0.443,5.2,63,22,42,0.349,110,0.573,11,0.636,4.2,94,42,53,0.447,178,0.528,12,0.566,4.5
484,1627789,Timothe Luwawu-Cabarrot,1610612755,PHI,51,29,22,795.0,14,7,8,0.5,72,0.194,4,0.206,9.1,58,9,50,0.155,129,0.45,13,0.5,8.5,72,16,58,0.222,198,0.364,17,0.398,8.6
485,202699,Tobias Harris,1610612746,LAC,80,39,41,2668.0,58,33,23,0.569,241,0.241,7,0.248,8.0,379,95,284,0.251,696,0.545,54,0.59,5.8,437,128,307,0.293,910,0.48,61,0.515,6.1
486,203107,Tomas Satoransky,1610612764,WAS,73,39,34,1643.0,72,39,33,0.542,202,0.356,8,0.371,9.9,161,28,129,0.174,286,0.563,21,0.608,9.1,233,67,162,0.288,480,0.485,29,0.517,9.4
487,2754,Tony Allen,1610612740,NOP,20,11,9,247.0,17,9,7,0.529,49,0.347,0,0.347,6.5,22,4,18,0.182,38,0.579,1,0.595,6.1,39,13,25,0.333,83,0.47,1,0.476,6.2
488,1628396,Tony Bradley,1610612762,UTA,9,6,3,29.0,4,3,1,0.75,6,0.667,1,0.8,3.2,7,4,3,0.571,13,0.538,2,0.636,3.4,11,7,4,0.636,18,0.611,3,0.733,3.4
489,2225,Tony Parker,1610612759,SAS,55,32,23,1071.0,7,2,4,0.286,53,0.132,3,0.14,14.7,88,9,79,0.102,138,0.638,13,0.704,10.0,95,11,83,0.116,189,0.503,16,0.549,10.3
490,203503,Tony Snell,1610612749,MIL,74,42,32,2028.0,9,1,9,0.111,49,0.184,1,0.188,15.9,131,18,113,0.137,268,0.489,26,0.541,8.9,140,19,122,0.136,312,0.449,27,0.491,9.4
491,1628470,Torrey Craig,1610612743,DEN,39,22,17,629.0,40,26,12,0.65,109,0.367,2,0.374,8.3,87,22,65,0.253,157,0.554,14,0.608,6.1,127,48,77,0.378,253,0.502,16,0.536,6.8
492,204037,Travis Wear,1610612747,LAL,17,7,10,228.0,0,0,0,0.0,12,0.0,1,0.0,0.0,38,14,22,0.368,61,0.623,7,0.704,6.6,38,14,22,0.368,69,0.551,8,0.623,6.6
493,1626203,Treveon Graham,1610612766,CHA,63,28,35,1050.0,42,30,12,0.714,110,0.382,3,0.393,5.5,79,20,59,0.253,177,0.446,18,0.497,8.6,121,50,71,0.413,282,0.429,21,0.464,7.5
494,2772,Trevor Ariza,1610612745,HOU,66,51,15,2229.0,33,19,14,0.576,172,0.192,7,0.2,11.1,256,48,207,0.188,409,0.626,32,0.679,7.2,289,67,221,0.232,559,0.517,39,0.556,7.7
495,202344,Trevor Booker,1610612754,IND,67,36,31,1148.0,117,75,38,0.641,289,0.405,8,0.416,5.3,200,57,140,0.285,370,0.541,31,0.59,5.2,317,132,178,0.416,645,0.491,39,0.523,5.2
496,203504,Trey Burke,1610612752,NYK,36,10,26,785.0,13,3,10,0.231,37,0.351,2,0.371,14.1,58,7,50,0.121,111,0.523,9,0.569,9.9,71,10,60,0.141,145,0.49,11,0.53,10.7
497,1626168,Trey Lyles,1610612743,DEN,73,41,32,1391.0,55,42,12,0.764,177,0.311,2,0.314,6.4,292,78,212,0.267,468,0.624,31,0.668,4.6,347,120,224,0.346,617,0.562,33,0.594,4.9
498,203590,Trey McKinney-Jones,1610612754,IND,1,1,0,1.0,0,0,0,0.0,0,0.0,0,0.0,0.0,0,0,0,0.0,0,0.0,0,0.0,0.0,0,0,0,0.0,0,0.0,0,0.0,0.0
499,202684,Tristan Thompson,1610612739,CLE,53,27,26,1072.0,126,93,29,0.738,289,0.436,8,0.448,5.0,226,34,189,0.15,375,0.603,28,0.651,5.4,352,127,218,0.361,651,0.541,36,0.572,5.3
500,203584,Troy Daniels,1610612756,PHX,79,20,59,1622.0,12,6,6,0.5,62,0.194,5,0.211,16.8,115,24,90,0.209,213,0.54,23,0.605,7.3,127,30,96,0.236,270,0.47,28,0.525,8.2
501,1627786,Troy Williams,1610612752,NYK,21,7,14,307.0,22,10,12,0.455,56,0.393,1,0.4,6.8,41,8,32,0.195,61,0.672,3,0.707,5.6,63,18,44,0.286,113,0.558,4,0.578,6.0
502,1628463,Tyler Cavanaugh,1610612737,ATL,38,11,27,503.0,44,31,12,0.705,114,0.386,2,0.393,4.9,80,20,60,0.25,143,0.559,8,0.593,4.9,124,51,72,0.411,246,0.504,10,0.525,4.9
503,1628416,Tyler Dorsey,1610612737,ATL,56,15,41,974.0,17,4,13,0.235,92,0.185,6,0.198,13.3,113,13,99,0.115,202,0.559,19,0.617,7.2,130,17,112,0.131,290,0.448,25,0.491,8.0
504,203898,Tyler Ennis,1610612747,LAL,54,22,32,683.0,19,6,12,0.316,68,0.279,3,0.292,8.2,76,10,66,0.132,123,0.618,6,0.65,7.9,95,16,78,0.168,186,0.511,9,0.537,7.9
505,204020,Tyler Johnson,1610612748,MIA,71,38,33,2025.0,34,16,18,0.471,129,0.264,5,0.274,12.2,210,43,167,0.205,410,0.512,38,0.565,7.4,244,59,185,0.242,534,0.457,43,0.497,8.1
506,1628399,Tyler Lydon,1610612743,DEN,1,1,0,2.0,0,0,0,0.0,0,0.0,0,0.0,0.0,0,0,0,0.0,0,0.0,0,0.0,0.0,0,0,0,0.0,0,0.0,0,0.0,0.0
507,1627755,Tyler Ulis,1610612756,PHX,71,20,51,1658.0,24,3,21,0.125,112,0.214,1,0.216,17.6,104,11,94,0.106,190,0.547,19,0.608,11.3,128,14,115,0.109,299,0.428,20,0.459,12.5
508,203092,Tyler Zeller,1610612749,MIL,64,26,38,1066.0,107,61,42,0.57,252,0.425,4,0.431,6.5,183,53,128,0.29,334,0.548,29,0.6,4.9,290,114,170,0.393,575,0.504,33,0.535,5.5
509,201936,Tyreke Evans,1610612763,MEM,51,18,33,1584.0,44,30,14,0.682,210,0.21,10,0.22,6.8,216,43,171,0.199,372,0.581,23,0.619,7.7,260,73,185,0.281,567,0.459,33,0.487,7.5
510,1627820,Tyrone Wallace,1610612746,LAC,30,17,13,851.0,21,10,10,0.476,92,0.228,4,0.239,12.3,84,14,71,0.167,140,0.6,12,0.656,8.6,105,24,81,0.229,221,0.475,16,0.512,9.3
511,2199,Tyson Chandler,1610612756,PHX,46,15,31,1151.0,134,89,44,0.664,268,0.5,7,0.513,4.9,284,89,197,0.313,471,0.603,32,0.647,4.2,418,178,241,0.426,719,0.581,39,0.615,4.4
512,1626145,Tyus Jones,1610612750,MIN,82,47,35,1467.0,16,3,13,0.188,63,0.254,1,0.258,17.4,116,14,101,0.121,206,0.563,21,0.627,9.6,132,17,114,0.129,267,0.494,22,0.539,10.5
513,2617,Udonis Haslem,1610612748,MIA,14,9,5,72.0,3,1,1,0.333,4,0.75,0,0.75,8.4,7,1,6,0.143,15,0.467,2,0.538,5.0,10,2,7,0.2,18,0.556,2,0.625,5.8
514,203505,Vander Blue,1610612747,LAL,5,1,4,45.0,0,0,0,0.0,1,0.0,0,0.0,0.0,1,0,1,0.0,1,1.0,1,0.0,7.2,1,0,1,0.0,2,0.5,1,1.0,7.2
515,203506,Victor Oladipo,1610612754,IND,75,48,27,2552.0,47,26,21,0.553,234,0.201,11,0.211,11.1,343,77,269,0.224,624,0.55,48,0.595,6.7,390,103,290,0.264,850,0.459,59,0.493,7.2
516,1713,Vince Carter,1610612758,SAC,58,20,38,1026.0,18,12,6,0.667,84,0.214,2,0.22,6.0,130,36,93,0.277,252,0.516,20,0.56,5.4,148,48,99,0.324,319,0.464,22,0.498,5.5
517,1626205,Vincent Hunter,1610612763,MEM,4,0,4,7.0,2,2,0,1.0,2,1.0,0,1.0,2.9,1,1,0,1.0,2,0.5,0,0.5,5.7,3,3,0,1.0,4,0.75,0,0.75,3.9
518,1627735,Wade Baldwin IV,1610612757,POR,7,4,3,80.0,1,0,1,0.0,3,0.333,0,0.333,28.9,7,0,7,0.0,11,0.636,1,0.7,7.6,8,0,8,0.0,14,0.571,1,0.615,10.3
519,1627215,Walter Lemon Jr.,1610612740,NOP,5,4,1,35.0,0,0,0,0.0,1,0.0,0,0.0,0.0,2,0,1,0.0,1,2.0,0,2.0,13.5,2,0,1,0.0,2,1.0,0,1.0,13.5
520,201961,Wayne Ellington,1610612748,MIA,76,41,35,2018.0,22,4,18,0.182,73,0.301,3,0.314,14.6,193,23,169,0.119,329,0.587,25,0.635,8.4,215,27,187,0.126,397,0.542,28,0.583,9.0
521,1627782,Wayne Selden,1610612763,MEM,35,10,25,691.0,16,2,14,0.125,53,0.302,5,0.333,17.5,40,11,29,0.275,65,0.615,4,0.656,10.8,56,13,43,0.232,117,0.479,9,0.519,12.7
522,1628411,Wes Iwundu,1610612753,ORL,62,18,44,1020.0,36,18,18,0.5,90,0.4,1,0.404,10.5,101,26,74,0.257,201,0.502,32,0.598,4.7,137,44,92,0.321,290,0.472,33,0.533,6.3
523,202325,Wesley Johnson,1610612746,LAC,74,38,36,1486.0,29,9,19,0.31,77,0.377,4,0.397,14.3,187,43,143,0.23,346,0.54,24,0.581,7.2,216,52,162,0.241,407,0.531,28,0.57,8.1
524,202083,Wesley Matthews,1610612742,DAL,63,20,43,2131.0,28,16,14,0.571,107,0.262,4,0.272,13.8,170,29,141,0.171,289,0.588,22,0.637,9.0,198,45,155,0.227,387,0.512,26,0.548,9.7
525,203115,Will Barton,1610612743,DEN,81,46,35,2683.0,70,23,47,0.329,293,0.239,8,0.246,9.8,339,55,282,0.162,583,0.581,49,0.635,5.8,409,78,329,0.191,840,0.487,57,0.522,6.4
526,1626161,Willie Cauley-Stein,1610612758,SAC,73,23,50,2044.0,131,82,50,0.626,356,0.368,6,0.374,6.6,379,101,278,0.266,646,0.587,34,0.619,4.7,510,183,328,0.359,956,0.533,40,0.557,5.2
527,203186,Willie Reed,1610612765,DET,42,20,22,428.0,35,24,10,0.686,118,0.297,2,0.302,5.4,86,27,59,0.314,167,0.515,12,0.555,4.8,121,51,69,0.421,274,0.442,14,0.465,5.0
528,1626195,Willy Hernangomez,1610612766,CHA,48,20,28,494.0,61,47,14,0.77,151,0.404,1,0.407,6.4,122,38,81,0.311,194,0.629,21,0.705,4.1,183,85,95,0.464,325,0.563,22,0.604,4.9
529,201163,Wilson Chandler,1610612743,DEN,74,41,33,2346.0,102,64,38,0.627,276,0.37,4,0.375,7.4,296,69,226,0.233,460,0.643,29,0.687,7.1,398,133,264,0.334,706,0.564,33,0.591,7.2
530,204098,Xavier Munford,1610612749,MIL,6,2,4,21.0,1,0,1,0.0,1,1.0,0,1.0,21.5,0,0,0,0.0,0,0.0,0,0.0,0.0,1,0,1,0.0,1,1.0,0,1.0,21.5
531,1628504,Xavier Rathan-Mayes,1610612763,MEM,5,0,5,118.0,0,0,0,0.0,2,0.0,0,0.0,0.0,5,0,5,0.0,10,0.5,0,0.5,10.0,5,0,5,0.0,12,0.417,0,0.417,10.0
532,202918,Xavier Silas,1610612738,BOS,2,1,1,7.0,1,1,0,1.0,2,0.5,0,0.5,6.2,1,0,1,0.0,2,0.5,0,0.5,5.9,2,1,1,0.5,3,0.667,0,0.667,6.1
533,1627812,Yogi Ferrell,1610612742,DAL,82,24,58,2282.0,26,5,22,0.192,141,0.184,5,0.191,14.7,223,39,182,0.175,438,0.509,41,0.562,8.1,249,44,204,0.177,566,0.44,46,0.479,8.8
534,1628380,Zach Collins,1610612757,POR,66,41,25,1045.0,45,27,16,0.6,129,0.349,6,0.366,6.5,176,56,120,0.318,309,0.57,19,0.607,5.1,221,83,136,0.376,421,0.525,25,0.558,5.4
535,203897,Zach LaVine,1610612741,CHI,24,9,15,656.0,9,4,5,0.444,63,0.143,1,0.145,5.5,85,16,70,0.188,129,0.659,7,0.697,6.7,94,20,75,0.213,186,0.505,8,0.528,6.5
536,2216,Zach Randolph,1610612758,SAC,59,18,41,1508.0,97,74,20,0.763,261,0.372,3,0.376,5.4,300,81,218,0.27,474,0.633,35,0.683,4.3,397,155,238,0.39,720,0.551,38,0.582,4.6
537,2585,Zaza Pachulia,1610612744,GSW,68,46,22,951.0,86,54,30,0.628,222,0.387,7,0.4,6.7,226,60,167,0.265,399,0.566,29,0.611,4.3,312,114,197,0.365,608,0.513,36,0.545,5.0
538,1627753,Zhou Qi,1610612745,HOU,18,14,4,124.0,6,4,1,0.667,21,0.286,0,0.286,6.6,16,8,8,0.5,33,0.485,2,0.516,4.7,22,12,9,0.545,51,0.431,2,0.449,5.1
