,PLAYER_ID,PLAYER_NAME,TEAM_ID,TEAM_ABBREVIATION,GP,W,L,MIN,OREB,OREB_CONTEST,OREB_UNCONTEST,OREB_CONTEST_PCT,OREB_CHANCES,OREB_CHANCE_PCT,OREB_CHANCE_DEFER,OREB_CHANCE_PCT_ADJ,AVG_OREB_DIST,DREB,DREB_CONTEST,DREB_UNCONTEST,DREB_CONTEST_PCT,DREB_CHANCES,DREB_CHANCE_PCT,DREB_CHANCE_DEFER,DREB_CHANCE_PCT_ADJ,AVG_DREB_DIST,REB,REB_CONTEST,REB_UNCONTEST,REB_CONTEST_PCT,REB_CHANCES,REB_CHANCE_PCT,REB_CHANCE_DEFER,REB_CHANCE_PCT_ADJ,AVG_REB_DIST
0,203932,Aaron Gordon,1610612753,ORL,16,8,8,520.0,30,18,10,0.6,62,0.484,1,0.492,4.4,90,16,48,0.178,113,0.796,5,0.833,6.1,120,34,58,0.283,170,0.706,6,0.732,5.7
1,1628988,Aaron Holiday,1610612754,IND,7,6,1,52.0,0,0,0,0.0,1,0.0,0,0.0,0.0,11,1,3,0.091,8,1.375,2,1.833,9.6,11,1,3,0.091,8,1.375,2,1.833,9.6
2,1627846,Abdel Nader,1610612760,OKC,6,5,1,11.0,1,0,1,0.0,2,0.5,0,0.5,20.6,2,2,0,1.0,2,1.0,0,1.0,4.0,3,2,1,0.667,4,0.75,0,0.75,9.5
3,201143,Al Horford,1610612738,BOS,17,9,8,501.0,27,12,13,0.444,61,0.443,2,0.458,9.9,79,20,42,0.253,139,0.568,13,0.627,5.9,106,32,55,0.302,196,0.541,15,0.586,6.8
4,202329,Al-Farouq Aminu,1610612757,POR,16,11,5,476.0,20,9,10,0.45,53,0.377,2,0.392,7.4,114,18,56,0.158,176,0.648,10,0.687,5.8,134,27,66,0.201,223,0.601,12,0.635,5.9
5,202692,Alec Burks,1610612762,UTA,13,7,6,193.0,1,2,0,2.0,5,0.2,0,0.2,4.7,13,2,8,0.154,20,0.65,3,0.765,7.0,14,4,8,0.286,24,0.583,3,0.667,6.6
6,203518,Alex Abrines,1610612760,OKC,14,9,5,303.0,2,0,2,0.0,11,0.182,1,0.2,23.6,20,1,16,0.05,31,0.645,4,0.741,9.9,22,1,18,0.045,42,0.524,5,0.595,11.4
7,203458,Alex Len,1610612737,ATL,17,3,14,371.0,35,22,9,0.629,83,0.422,0,0.422,4.8,65,14,31,0.215,135,0.481,14,0.537,4.5,100,36,40,0.36,213,0.469,14,0.503,4.7
8,1627816,Alex Poythress,1610612737,ATL,13,3,10,195.0,20,11,8,0.55,44,0.455,1,0.465,6.4,29,5,18,0.172,42,0.69,2,0.725,4.4,49,16,26,0.327,82,0.598,3,0.62,5.3
9,1628035,Alfonzo McKinnie,1610612744,GSW,16,12,4,251.0,19,15,3,0.789,45,0.422,2,0.442,4.7,42,8,19,0.19,55,0.764,3,0.808,4.5,61,23,22,0.377,95,0.642,5,0.678,4.5
10,1628993,Alize Johnson,1610612754,IND,3,2,1,9.0,0,0,0,0.0,2,0.0,0,0.0,0.0,4,1,3,0.25,6,0.667,1,0.8,4.5,4,1,3,0.25,7,0.571,1,0.667,4.5
11,203459,Allen Crabbe,1610612751,BKN,16,7,9,379.0,6,4,3,0.667,13,0.462,1,0.5,6.7,44,7,20,0.159,49,0.898,3,0.957,6.6,50,11,23,0.22,61,0.82,4,0.877,6.7
12,1629019,Allonzo Trier,1610612752,NYK,17,4,13,411.0,12,3,8,0.25,26,0.462,1,0.48,13.5,36,3,24,0.083,55,0.655,3,0.692,8.9,48,6,32,0.125,78,0.615,4,0.649,10.0
13,101161,Amir Johnson,1610612755,PHI,19,12,7,189.0,16,12,3,0.75,33,0.485,2,0.516,3.6,45,13,13,0.289,58,0.776,4,0.833,3.9,61,25,16,0.41,90,0.678,6,0.726,3.8
14,203083,Andre Drummond,1610612765,DET,14,8,6,470.0,85,59,22,0.694,144,0.59,1,0.594,3.8,142,35,62,0.246,188,0.755,6,0.78,3.9,227,94,84,0.414,323,0.703,7,0.718,3.9
15,2738,Andre Iguodala,1610612744,GSW,16,10,6,345.0,10,2,8,0.2,16,0.625,0,0.625,12.7,39,4,24,0.103,63,0.619,5,0.672,9.6,49,6,32,0.122,79,0.62,5,0.662,10.2
16,1626150,Andrew Harrison,1610612739,CLE,5,2,3,67.0,3,0,3,0.0,4,0.75,0,0.75,12.5,9,2,7,0.222,14,0.643,1,0.692,5.9,12,2,10,0.167,18,0.667,1,0.706,7.6
17,203952,Andrew Wiggins,1610612750,MIN,13,6,7,436.0,8,5,2,0.625,23,0.348,3,0.4,9.9,44,5,23,0.114,52,0.846,6,0.957,6.9,52,10,25,0.192,74,0.703,9,0.8,7.5
18,1629014,Anfernee Simons,1610612757,POR,4,3,1,22.0,0,0,0,0.0,2,0.0,0,0.0,0.0,5,1,4,0.2,6,0.833,0,0.833,5.1,5,1,4,0.2,8,0.625,0,0.625,5.1
19,1627790,Ante Zizic,1610612739,CLE,13,2,11,117.0,14,8,5,0.571,32,0.438,1,0.452,9.4,26,5,11,0.192,43,0.605,5,0.684,5.0,40,13,16,0.325,74,0.541,6,0.588,5.5
20,203076,Anthony Davis,1610612740,NOP,14,10,4,526.0,49,32,14,0.653,85,0.576,1,0.583,6.2,125,45,55,0.36,171,0.731,9,0.772,4.3,174,77,69,0.443,254,0.685,10,0.713,5.0
21,201229,Anthony Tolliver,1610612750,MIN,14,5,9,267.0,7,5,3,0.714,19,0.368,2,0.412,11.7,32,5,17,0.156,57,0.561,6,0.627,4.5,39,10,20,0.256,75,0.52,8,0.582,5.8
22,1628469,Antonio Blakeney,1610612741,CHI,17,4,13,319.0,4,4,0,1.0,14,0.286,1,0.308,3.6,33,3,19,0.091,39,0.846,6,1.0,8.4,37,7,19,0.189,50,0.74,7,0.86,7.7
23,203382,Aron Baynes,1610612738,BOS,14,7,7,193.0,23,16,3,0.696,34,0.676,0,0.676,4.3,33,5,18,0.152,48,0.688,6,0.786,4.2,56,21,21,0.375,82,0.683,6,0.737,4.3
24,203085,Austin Rivers,1610612764,WAS,16,5,11,370.0,5,2,2,0.4,8,0.625,0,0.625,2.3,31,1,18,0.032,47,0.66,5,0.738,9.0,36,3,20,0.083,53,0.679,5,0.75,8.1
25,202340,Avery Bradley,1610612746,LAC,10,6,4,267.0,7,4,4,0.571,17,0.412,0,0.412,6.6,10,0,8,0.0,33,0.303,3,0.333,12.7,17,4,12,0.235,50,0.34,3,0.362,10.6
26,1628389,Bam Adebayo,1610612748,MIA,16,6,10,282.0,27,14,10,0.519,68,0.397,0,0.397,6.0,65,15,24,0.231,89,0.73,4,0.765,5.6,92,29,34,0.315,148,0.622,4,0.639,5.7
27,203463,Ben McLemore,1610612758,SAC,5,3,2,24.0,0,0,0,0.0,0,0.0,0,0.0,0.0,0,0,0,0.0,0,0.0,1,0.0,0.0,0,0,0,0.0,0,0.0,1,0.0,0.0
28,1627732,Ben Simmons,1610612755,PHI,18,12,6,594.0,36,20,11,0.556,77,0.468,2,0.48,8.2,130,11,68,0.085,126,1.032,4,1.066,7.7,166,31,79,0.187,193,0.86,6,0.888,7.8
29,202687,Bismack Biyombo,1610612766,CHA,8,3,5,68.0,5,2,3,0.4,13,0.385,0,0.385,5.7,12,2,8,0.167,23,0.522,3,0.6,3.8,17,4,11,0.235,35,0.486,3,0.531,4.4
30,201933,Blake Griffin,1610612765,DET,14,8,6,501.0,24,10,11,0.417,57,0.421,4,0.453,9.5,122,26,54,0.213,176,0.693,13,0.748,4.7,146,36,65,0.247,223,0.655,17,0.709,5.4
31,1626246,Boban Marjanovic,1610612746,LAC,13,8,5,152.0,18,11,3,0.611,32,0.563,0,0.563,3.2,46,14,12,0.304,58,0.793,3,0.836,4.0,64,25,15,0.391,89,0.719,3,0.744,3.7
32,1626171,Bobby Portis,1610612741,CHI,4,1,3,113.0,6,3,3,0.5,15,0.4,0,0.4,7.7,34,4,22,0.118,42,0.81,0,0.81,6.2,40,7,25,0.175,55,0.727,0,0.727,6.6
33,203992,Bogdan Bogdanovic,1610612758,SAC,6,2,4,132.0,1,0,0,0.0,1,1.0,0,1.0,0.0,14,0,1,0.0,3,4.667,1,7.0,22.1,15,0,1,0.0,4,3.75,1,5.0,22.1
34,202711,Bojan Bogdanovic,1610612754,IND,17,11,6,519.0,5,2,2,0.4,28,0.179,2,0.192,7.5,59,5,31,0.085,78,0.756,10,0.868,7.4,64,7,33,0.109,101,0.634,12,0.719,7.6
35,202954,Brad Wanamaker,1610612738,BOS,4,3,1,24.0,0,0,0,0.0,0,0.0,0,0.0,0.0,3,0,2,0.0,2,1.5,0,1.5,7.2,3,0,2,0.0,2,1.5,0,1.5,7.2
36,203078,Bradley Beal,1610612764,WAS,16,5,11,540.0,9,5,4,0.556,22,0.409,3,0.474,12.2,65,11,31,0.169,76,0.855,2,0.878,7.3,74,16,35,0.216,96,0.771,5,0.813,7.9
37,1627742,Brandon Ingram,1610612747,LAL,12,7,5,376.0,10,3,5,0.3,24,0.417,2,0.455,11.4,44,10,23,0.227,61,0.721,5,0.786,6.1,54,13,28,0.241,84,0.643,7,0.701,7.4
38,201572,Brook Lopez,1610612749,MIL,16,12,4,435.0,7,3,3,0.429,10,0.7,0,0.7,8.6,52,18,24,0.346,78,0.667,7,0.732,8.2,59,21,27,0.356,88,0.67,7,0.728,8.3
39,1628971,Bruce Brown,1610612765,DET,8,3,5,104.0,3,2,1,0.667,9,0.333,0,0.333,3.5,9,2,4,0.222,9,1.0,0,1.0,12.3,12,4,5,0.333,17,0.706,0,0.706,9.5
40,1627854,Bryn Forbes,1610612759,SAS,16,8,8,462.0,3,0,3,0.0,10,0.3,1,0.333,21.2,23,5,15,0.217,40,0.575,1,0.59,6.7,26,5,18,0.192,50,0.52,2,0.542,8.6
41,1627741,Buddy Hield,1610612758,SAC,17,9,8,527.0,19,11,7,0.579,38,0.5,1,0.514,4.9,74,6,35,0.081,79,0.937,1,0.949,7.6,93,17,42,0.183,117,0.795,2,0.809,7.0
42,203710,C.J. Williams,1610612750,MIN,6,2,4,53.0,0,0,0,0.0,0,0.0,0,0.0,0.0,2,0,1,0.0,1,2.0,0,2.0,5.1,2,0,1,0.0,1,2.0,0,2.0,5.1
43,203468,CJ McCollum,1610612757,POR,16,11,5,529.0,18,6,11,0.333,35,0.514,0,0.514,11.7,44,3,22,0.068,69,0.638,5,0.688,9.9,62,9,33,0.145,102,0.608,5,0.639,10.2
44,101139,CJ Miles,1610612761,TOR,13,11,2,195.0,5,3,1,0.6,7,0.714,0,0.714,14.9,19,2,11,0.105,22,0.864,1,0.905,7.9,24,5,12,0.208,29,0.828,1,0.857,9.5
45,1628403,Caleb Swanigan,1610612757,POR,8,6,2,85.0,10,4,3,0.4,19,0.526,0,0.526,3.3,25,3,7,0.12,29,0.862,1,0.893,6.1,35,7,10,0.2,48,0.729,1,0.745,5.1
46,1626166,Cameron Payne,1610612741,CHI,15,3,12,324.0,9,3,5,0.333,17,0.529,0,0.529,14.6,20,0,13,0.0,22,0.909,4,1.111,10.9,29,3,18,0.103,39,0.744,4,0.829,11.5
47,1627747,Caris LeVert,1610612751,BKN,14,6,8,416.0,14,5,7,0.357,33,0.424,3,0.467,9.7,46,5,18,0.109,44,1.045,1,1.07,8.7,60,10,25,0.167,76,0.789,4,0.833,9.0
48,2546,Carmelo Anthony,1610612745,HOU,10,4,6,294.0,9,5,4,0.556,22,0.409,1,0.429,14.6,45,9,24,0.2,59,0.763,5,0.833,5.3,54,14,28,0.259,78,0.692,6,0.75,6.9
49,1626224,Cedi Osman,1610612739,CLE,13,1,12,391.0,11,2,9,0.182,34,0.324,0,0.324,17.2,51,3,28,0.059,70,0.729,3,0.761,6.0,62,5,37,0.081,97,0.639,3,0.66,8.3
50,1628990,Chandler Hutchison,1610612741,CHI,16,4,12,309.0,10,3,6,0.3,22,0.455,1,0.476,10.6,54,9,31,0.167,82,0.659,5,0.701,7.1,64,12,37,0.188,101,0.634,6,0.674,7.9
51,202718,Chandler Parsons,1610612763,MEM,3,2,1,46.0,1,1,0,1.0,2,0.5,0,0.5,5.4,3,0,2,0.0,6,0.5,0,0.5,3.5,4,1,2,0.25,8,0.5,0,0.5,4.2
52,101112,Channing Frye,1610612739,CLE,3,1,2,31.0,0,0,0,0.0,0,0.0,0,0.0,0.0,7,1,6,0.143,9,0.778,0,0.778,7.4,7,1,6,0.143,9,0.778,0,0.778,7.4
53,1627767,Cheick Diallo,1610612740,NOP,12,6,6,122.0,14,9,4,0.643,25,0.56,0,0.56,4.8,36,10,22,0.278,51,0.706,4,0.766,4.0,50,19,26,0.38,75,0.667,4,0.704,4.1
54,1629002,Chimezie Metu,1610612759,SAS,9,3,6,54.0,4,3,1,0.75,6,0.667,1,0.8,3.9,9,1,6,0.111,16,0.563,1,0.6,5.6,13,4,7,0.308,22,0.591,2,0.65,5.2
55,1628449,Chris Boucher,1610612761,TOR,2,1,1,9.0,2,2,0,1.0,3,0.667,0,0.667,1.1,3,1,2,0.333,5,0.6,0,0.6,3.3,5,3,2,0.6,8,0.625,0,0.625,2.4
56,101108,Chris Paul,1610612745,HOU,13,8,5,448.0,8,4,2,0.5,25,0.32,3,0.364,10.6,58,6,29,0.103,92,0.63,8,0.69,6.7,66,10,31,0.152,116,0.569,11,0.629,6.9
57,1626174,Christian Wood,1610612749,MIL,4,4,0,19.0,2,2,0,1.0,6,0.333,0,0.333,3.8,5,2,4,0.4,8,0.625,0,0.625,2.3,7,4,4,0.571,13,0.538,0,0.538,2.8
58,203991,Clint Capela,1610612745,HOU,15,8,7,500.0,64,35,24,0.547,128,0.5,2,0.508,7.6,104,17,47,0.163,133,0.782,10,0.846,5.6,168,52,71,0.31,258,0.651,12,0.683,6.4
59,203469,Cody Zeller,1610612766,CHA,16,8,8,390.0,29,19,10,0.655,81,0.358,2,0.367,7.1,62,14,41,0.226,122,0.508,19,0.602,5.8,91,33,51,0.363,202,0.45,21,0.503,6.3
60,1629012,Collin Sexton,1610612739,CLE,15,2,13,396.0,10,2,6,0.2,23,0.435,0,0.435,14.2,28,2,15,0.071,35,0.8,3,0.875,6.8,38,4,21,0.105,58,0.655,3,0.691,9.0
61,202709,Cory Joseph,1610612754,IND,17,11,6,441.0,5,2,1,0.4,13,0.385,0,0.385,9.1,48,7,26,0.146,60,0.8,2,0.828,9.6,53,9,27,0.17,71,0.746,2,0.768,9.5
62,1626245,Cristiano Felicio,1610612741,CHI,13,3,10,195.0,15,9,3,0.6,29,0.517,0,0.517,5.1,40,13,11,0.325,66,0.606,7,0.678,3.7,55,22,14,0.4,94,0.585,7,0.632,4.1
63,1626156,D'Angelo Russell,1610612751,BKN,17,7,10,470.0,9,4,3,0.444,21,0.429,2,0.474,12.2,50,3,31,0.06,67,0.746,3,0.781,6.3,59,7,34,0.119,88,0.67,5,0.711,7.2
64,201571,D.J. Augustin,1610612753,ORL,17,9,8,466.0,10,4,5,0.4,20,0.5,1,0.526,9.7,27,2,17,0.074,43,0.628,3,0.675,13.1,37,6,22,0.162,62,0.597,4,0.638,12.4
65,1627745,Damian Jones,1610612744,GSW,18,12,6,310.0,24,10,12,0.417,50,0.48,1,0.49,7.6,35,6,17,0.171,68,0.515,7,0.574,6.9,59,16,29,0.271,118,0.5,8,0.536,7.7
66,203081,Damian Lillard,1610612757,POR,16,11,5,553.0,15,6,10,0.4,45,0.333,5,0.375,12.0,70,6,36,0.086,72,0.972,3,1.014,8.0,85,12,46,0.141,115,0.739,8,0.794,9.0
67,1627814,Damion Lee,1610612744,GSW,6,3,3,61.0,0,0,0,0.0,2,0.0,0,0.0,0.0,10,1,9,0.1,13,0.769,0,0.769,6.4,10,1,9,0.1,15,0.667,0,0.667,6.4
68,1628422,Damyean Dotson,1610612752,NYK,15,3,12,403.0,12,4,7,0.333,18,0.667,0,0.667,11.7,56,3,23,0.054,66,0.848,4,0.903,6.5,68,7,30,0.103,82,0.829,4,0.872,7.0
69,1627772,Daniel Hamilton,1610612737,ATL,1,0,1,8.0,0,0,0,0.0,0,0.0,0,0.0,0.0,0,0,0,0.0,0,0.0,0,0.0,0.0,0,0,0,0.0,0,0.0,0,0.0,0.0
70,1628464,Daniel Theis,1610612738,BOS,9,5,4,104.0,10,4,4,0.4,20,0.5,0,0.5,8.1,14,6,8,0.429,32,0.438,3,0.483,4.4,24,10,12,0.417,51,0.471,3,0.5,5.7
71,201568,Danilo Gallinari,1610612746,LAC,15,10,5,463.0,15,9,5,0.6,33,0.455,1,0.469,5.8,71,10,37,0.141,109,0.651,7,0.696,5.4,86,19,42,0.221,138,0.623,8,0.662,5.5
72,201980,Danny Green,1610612761,TOR,17,13,4,474.0,13,5,4,0.385,26,0.5,0,0.5,9.2,54,11,28,0.204,75,0.72,5,0.771,5.8,67,16,32,0.239,100,0.67,5,0.705,6.3
73,201967,Dante Cunningham,1610612759,SAS,16,8,8,359.0,21,9,7,0.429,44,0.477,0,0.477,8.2,47,10,26,0.213,83,0.566,9,0.635,5.9,68,19,33,0.279,123,0.553,9,0.596,6.3
74,203957,Dante Exum,1610612762,UTA,17,8,9,297.0,6,0,5,0.0,12,0.5,1,0.545,15.5,27,3,11,0.111,30,0.9,2,0.964,7.0,33,3,16,0.091,39,0.846,3,0.917,9.2
75,203967,Dario Saric,1610612750,MIN,16,10,6,472.0,23,14,8,0.609,68,0.338,3,0.354,6.3,76,20,31,0.263,111,0.685,4,0.71,4.9,99,34,39,0.343,176,0.563,7,0.586,5.2
76,203121,Darius Miller,1610612740,NOP,13,10,3,249.0,2,0,3,0.0,5,0.4,0,0.4,26.1,14,6,6,0.429,21,0.667,2,0.737,8.1,16,6,9,0.375,25,0.64,2,0.696,10.6
77,201954,Darren Collison,1610612754,IND,17,11,6,463.0,8,1,6,0.125,21,0.381,0,0.381,24.7,30,0,16,0.0,44,0.682,3,0.732,9.9,38,1,22,0.026,64,0.594,3,0.623,13.4
78,1629133,Daryl Macon,1610612742,DAL,1,0,1,1.0,0,0,0,0.0,0,0.0,0,0.0,0.0,0,0,0,0.0,0,0.0,0,0.0,0.0,0,0,0,0.0,0,0.0,0,0.0,0.0
79,1628021,David Nwaba,1610612739,CLE,11,2,9,151.0,3,2,1,0.667,13,0.231,1,0.25,2.8,23,3,16,0.13,29,0.793,1,0.821,5.9,26,5,17,0.192,40,0.65,2,0.684,5.5
80,202722,Davis Bertans,1610612759,SAS,14,7,7,217.0,7,3,4,0.429,12,0.583,0,0.583,11.8,23,8,13,0.348,51,0.451,3,0.479,4.4,30,11,17,0.367,59,0.508,3,0.536,6.2
81,1628432,Davon Reed,1610612754,IND,1,1,0,2.0,0,0,0,0.0,0,0.0,0,0.0,0.0,0,0,0,0.0,0,0.0,0,0.0,0.0,0,0,0,0.0,0,0.0,0,0.0,0.0
82,1628368,De'Aaron Fox,1610612758,SAC,17,9,8,554.0,10,3,5,0.3,20,0.5,1,0.526,9.5,60,8,32,0.133,67,0.896,6,0.984,8.7,70,11,37,0.157,84,0.833,7,0.909,8.8
83,1629001,De'Anthony Melton,1610612756,PHX,4,1,3,42.0,0,0,0,0.0,2,0.0,0,0.0,0.0,8,0,7,0.0,9,0.889,0,0.889,7.6,8,0,7,0.0,11,0.727,0,0.727,7.6
84,201599,DeAndre Jordan,1610612742,DAL,16,7,9,518.0,42,29,13,0.69,103,0.408,1,0.412,4.1,176,32,86,0.182,216,0.815,10,0.854,4.4,218,61,99,0.28,313,0.696,11,0.722,4.3
85,1627761,DeAndre' Bembry,1610612737,ATL,17,3,14,394.0,10,4,5,0.4,24,0.417,2,0.455,10.0,67,13,39,0.194,99,0.677,2,0.691,7.2,77,17,44,0.221,119,0.647,4,0.67,7.8
86,201942,DeMar DeRozan,1610612759,SAS,16,8,8,588.0,13,5,7,0.385,36,0.361,2,0.382,13.8,87,12,59,0.138,131,0.664,11,0.725,7.2,100,17,66,0.17,163,0.613,13,0.667,8.0
87,201960,DeMarre Carroll,1610612751,BKN,6,2,4,126.0,7,1,5,0.143,16,0.438,0,0.438,17.2,23,3,10,0.13,34,0.676,0,0.676,5.6,30,4,15,0.133,49,0.612,0,0.612,8.6
88,1629152,DeVaughn Akoon-Purcell,1610612743,DEN,4,4,0,13.0,1,0,1,0.0,2,0.5,0,0.5,26.3,2,0,0,0.0,1,2.0,1,0.0,0.0,3,0,1,0.0,3,1.0,1,1.5,26.3
89,1629028,Deandre Ayton,1610612756,PHX,16,3,13,517.0,39,25,11,0.641,81,0.481,4,0.506,6.3,127,30,61,0.236,158,0.804,9,0.852,4.1,166,55,72,0.331,231,0.719,13,0.761,4.6
90,1626153,Delon Wright,1610612761,TOR,12,8,4,197.0,9,5,3,0.556,11,0.818,0,0.818,4.6,17,3,8,0.176,25,0.68,4,0.81,6.3,26,8,11,0.308,36,0.722,4,0.813,5.6
91,203471,Dennis Schroder,1610612760,OKC,16,10,6,483.0,11,3,8,0.273,34,0.324,5,0.379,14.3,62,3,36,0.048,67,0.925,1,0.939,8.7,73,6,44,0.082,101,0.723,6,0.768,9.8
92,1628372,Dennis Smith Jr.,1610612742,DAL,15,7,8,428.0,10,2,8,0.2,32,0.313,3,0.345,16.0,33,2,21,0.061,65,0.508,6,0.559,9.4,43,4,29,0.093,97,0.443,9,0.489,10.8
93,1629126,Deonte Burton,1610612760,OKC,7,4,3,43.0,1,0,1,0.0,3,0.333,0,0.333,3.9,7,2,4,0.286,7,1.0,0,1.0,5.8,8,2,5,0.25,10,0.8,0,0.8,5.5
94,202324,Derrick Favors,1610612762,UTA,16,7,9,370.0,47,20,18,0.426,82,0.573,0,0.573,5.3,63,16,24,0.254,92,0.685,2,0.7,4.4,110,36,42,0.327,169,0.651,2,0.659,4.6
95,1627884,Derrick Jones Jr.,1610612748,MIA,11,3,8,164.0,14,9,4,0.643,30,0.467,1,0.483,7.0,18,4,10,0.222,40,0.45,3,0.486,5.6,32,13,14,0.406,68,0.471,4,0.5,6.3
96,201565,Derrick Rose,1610612750,MIN,15,6,9,453.0,13,6,7,0.462,34,0.382,3,0.419,8.4,43,5,32,0.116,70,0.614,4,0.652,9.5,56,11,39,0.196,102,0.549,7,0.589,9.1
97,1628401,Derrick White,1610612759,SAS,7,2,5,149.0,1,1,0,1.0,6,0.167,1,0.2,10.3,13,2,7,0.154,15,0.867,4,1.182,7.3,14,3,7,0.214,20,0.7,5,0.933,7.6
98,1626164,Devin Booker,1610612756,PHX,13,3,10,471.0,8,2,3,0.25,18,0.444,0,0.444,9.9,41,4,22,0.098,42,0.976,5,1.108,7.2,49,6,25,0.122,60,0.817,5,0.891,7.7
99,2734,Devin Harris,1610612742,DAL,6,4,2,85.0,0,0,0,0.0,2,0.0,0,0.0,0.0,10,2,6,0.2,8,1.25,0,1.25,9.2,10,2,6,0.2,10,1.0,0,1.0,9.2
100,1628984,Devonte' Graham,1610612766,CHA,3,0,3,25.0,0,0,0,0.0,1,0.0,0,0.0,0.0,2,0,2,0.0,2,1.0,0,1.0,7.4,2,0,2,0.0,3,0.667,0,0.667,7.4
101,203473,Dewayne Dedmon,1610612737,ATL,11,2,9,223.0,12,6,3,0.5,26,0.462,0,0.462,11.2,63,20,30,0.317,77,0.818,7,0.9,4.8,75,26,33,0.347,98,0.765,7,0.824,5.9
102,1628415,Dillon Brooks,1610612763,MEM,11,7,4,208.0,6,4,2,0.667,15,0.4,0,0.4,5.1,17,5,9,0.294,25,0.68,2,0.739,6.1,23,9,11,0.391,38,0.605,2,0.639,6.0
103,1627734,Domantas Sabonis,1610612754,IND,16,10,6,392.0,38,26,8,0.684,82,0.463,3,0.481,4.6,114,21,45,0.184,136,0.838,9,0.898,4.5,152,47,53,0.309,211,0.72,12,0.764,4.5
104,1628378,Donovan Mitchell,1610612762,UTA,15,8,7,508.0,6,2,3,0.333,20,0.3,0,0.3,4.4,33,5,16,0.152,35,0.943,1,0.971,11.1,39,7,19,0.179,53,0.736,1,0.75,10.0
105,1628978,Donte DiVincenzo,1610612749,MIL,14,10,4,254.0,7,5,2,0.714,14,0.5,0,0.5,8.9,36,4,28,0.111,51,0.706,5,0.783,8.2,43,9,30,0.209,65,0.662,5,0.717,8.3
106,1627827,Dorian Finney-Smith,1610612742,DAL,16,7,9,430.0,27,17,10,0.63,49,0.551,1,0.563,8.2,37,6,20,0.162,76,0.487,10,0.561,5.3,64,23,30,0.359,124,0.516,11,0.566,6.8
107,203926,Doug McDermott,1610612754,IND,17,11,6,278.0,3,1,1,0.333,4,0.75,0,0.75,22.1,14,2,6,0.143,21,0.667,1,0.7,5.6,17,3,7,0.176,24,0.708,1,0.739,8.9
108,1627733,Dragan Bender,1610612756,PHX,6,1,5,26.0,2,2,0,1.0,3,0.667,0,0.667,2.7,4,1,2,0.25,6,0.667,1,0.8,4.6,6,3,2,0.5,8,0.75,1,0.857,3.8
109,203110,Draymond Green,1610612744,GSW,13,10,3,396.0,11,7,2,0.636,28,0.393,2,0.423,5.5,87,17,45,0.195,139,0.626,3,0.64,5.1,98,24,47,0.245,157,0.624,5,0.645,5.2
110,1629234,Drew Eubanks,1610612759,SAS,3,0,3,13.0,1,0,0,0.0,0,0.0,0,0.0,0.0,0,0,0,0.0,0,0.0,0,0.0,0.0,1,0,0,0.0,0,0.0,0,0.0,0.0
111,1629130,Duncan Robinson,1610612748,MIA,3,2,1,17.0,0,0,0,0.0,1,0.0,0,0.0,0.0,5,1,4,0.2,6,0.833,0,0.833,7.2,5,1,4,0.2,6,0.833,0,0.833,7.2
112,1628407,Dwayne Bacon,1610612766,CHA,9,6,3,109.0,1,0,1,0.0,2,0.5,0,0.5,22.9,15,4,10,0.267,24,0.625,1,0.652,4.9,16,4,11,0.25,25,0.64,1,0.667,6.1
113,2730,Dwight Howard,1610612764,WAS,9,4,5,230.0,24,20,5,0.833,56,0.429,0,0.429,3.0,59,16,37,0.271,97,0.608,7,0.656,4.0,83,36,42,0.434,149,0.557,7,0.585,3.7
114,203939,Dwight Powell,1610612742,DAL,15,7,8,239.0,16,7,8,0.438,50,0.32,2,0.333,7.5,40,10,20,0.25,58,0.69,2,0.714,5.5,56,17,28,0.304,106,0.528,4,0.549,5.8
115,2548,Dwyane Wade,1610612748,MIA,9,4,5,231.0,12,6,5,0.5,19,0.632,0,0.632,6.3,24,3,18,0.125,39,0.615,2,0.649,4.6,36,9,23,0.25,58,0.621,2,0.643,5.3
116,1629058,Dzanan Musa,1610612751,BKN,6,3,3,22.0,1,0,1,0.0,1,1.0,0,1.0,16.4,2,1,0,0.5,2,1.0,0,1.0,3.8,3,1,1,0.333,3,1.0,0,1.0,10.1
117,202734,E'Twaun Moore,1610612740,NOP,17,10,7,534.0,14,7,6,0.5,29,0.483,2,0.519,11.2,26,3,14,0.115,40,0.65,4,0.722,13.2,40,10,20,0.25,67,0.597,6,0.656,12.2
118,202334,Ed Davis,1610612751,BKN,17,7,10,296.0,54,33,12,0.611,105,0.514,1,0.519,4.2,87,16,41,0.184,131,0.664,6,0.696,4.0,141,49,53,0.348,230,0.613,7,0.632,4.0
119,1628410,Edmond Sumner,1610612754,IND,5,4,1,20.0,1,0,1,0.0,2,0.5,0,0.5,19.2,0,0,0,0.0,0,0.0,0,0.0,0.0,1,0,1,0.0,2,0.5,0,0.5,19.2
120,202327,Ekpe Udoh,1610612762,UTA,13,6,7,62.0,2,0,1,0.0,6,0.333,1,0.4,4.9,9,1,5,0.111,10,0.9,1,1.0,6.4,11,1,6,0.091,16,0.688,2,0.786,6.2
121,203901,Elfrid Payton,1610612740,NOP,6,5,1,152.0,7,4,1,0.571,16,0.438,0,0.438,9.9,24,3,16,0.125,32,0.75,1,0.774,7.7,31,7,17,0.226,47,0.66,1,0.674,8.2
122,1629059,Elie Okobo,1610612756,PHX,11,2,9,166.0,2,0,2,0.0,2,1.0,0,1.0,14.8,14,3,10,0.214,20,0.7,1,0.737,7.5,16,3,12,0.188,22,0.727,1,0.762,8.4
123,1626144,Emmanuel Mudiay,1610612752,NYK,10,3,7,204.0,9,3,5,0.333,20,0.45,0,0.45,15.7,20,2,14,0.1,35,0.571,4,0.645,7.8,29,5,19,0.172,54,0.537,4,0.58,10.1
124,202683,Enes Kanter,1610612752,NYK,17,4,13,448.0,77,48,14,0.623,134,0.575,3,0.588,6.5,122,22,49,0.18,170,0.718,11,0.767,4.7,199,70,63,0.352,298,0.668,14,0.701,5.4
125,202339,Eric Bledsoe,1610612749,MIL,16,12,4,464.0,20,13,4,0.65,30,0.667,1,0.69,5.8,54,2,41,0.037,83,0.651,8,0.72,10.7,74,15,45,0.203,111,0.667,9,0.725,9.4
126,201569,Eric Gordon,1610612745,HOU,12,6,6,385.0,6,2,4,0.333,24,0.25,2,0.273,15.1,27,3,18,0.111,44,0.614,3,0.659,8.6,33,5,22,0.152,67,0.493,5,0.532,9.8
127,101141,Ersan Ilyasova,1610612749,MIL,16,12,4,349.0,26,17,6,0.654,69,0.377,3,0.394,4.7,69,17,36,0.246,110,0.627,5,0.657,5.4,95,34,42,0.358,174,0.546,8,0.572,5.2
128,203095,Evan Fournier,1610612753,ORL,17,9,8,501.0,6,1,5,0.167,23,0.261,2,0.286,18.0,44,6,28,0.136,68,0.647,4,0.688,8.8,50,7,33,0.14,91,0.549,6,0.588,9.4
129,202323,Evan Turner,1610612757,POR,16,11,5,412.0,6,2,4,0.333,22,0.273,1,0.286,12.7,76,5,31,0.066,87,0.874,7,0.95,5.2,82,7,35,0.085,106,0.774,8,0.837,5.6
130,1628402,Frank Jackson,1610612740,NOP,11,6,5,129.0,1,0,1,0.0,3,0.333,1,0.5,6.9,6,1,2,0.167,4,1.5,0,1.5,13.8,7,1,3,0.143,7,1.0,1,1.167,12.1
131,1626163,Frank Kaminsky,1610612766,CHA,5,3,2,26.0,2,1,1,0.5,5,0.4,0,0.4,2.7,5,2,2,0.4,4,1.25,0,1.25,4.4,7,3,3,0.429,7,1.0,0,1.0,3.8
132,1628412,Frank Mason,1610612758,SAC,16,8,8,242.0,3,1,3,0.333,8,0.375,1,0.429,13.2,23,2,8,0.087,23,1.0,3,1.15,8.1,26,3,11,0.115,31,0.839,4,0.963,9.9
133,1628373,Frank Ntilikina,1610612752,NYK,17,4,13,421.0,1,0,1,0.0,15,0.067,1,0.071,20.6,30,0,22,0.0,43,0.698,1,0.714,12.3,31,0,23,0.0,57,0.544,2,0.564,12.4
134,1627832,Fred VanVleet,1610612761,TOR,13,10,3,310.0,7,3,3,0.429,10,0.7,0,0.7,15.8,24,0,17,0.0,21,1.143,3,1.333,9.7,31,3,20,0.097,30,1.033,3,1.148,11.3
135,1627788,Furkan Korkmaz,1610612755,PHI,12,7,5,132.0,5,0,4,0.0,9,0.556,0,0.556,19.4,21,0,15,0.0,27,0.778,2,0.84,7.9,26,0,19,0.0,34,0.765,2,0.813,10.1
136,202066,Garrett Temple,1610612763,MEM,16,11,5,515.0,6,3,2,0.5,24,0.25,2,0.273,11.7,52,9,28,0.173,71,0.732,3,0.765,8.1,58,12,30,0.207,90,0.644,5,0.682,8.2
137,1629109,Gary Clark,1610612745,HOU,14,7,7,241.0,11,4,7,0.364,19,0.579,1,0.611,10.6,35,7,16,0.2,54,0.648,2,0.673,7.2,46,11,23,0.239,73,0.63,3,0.657,8.3
138,203914,Gary Harris,1610612743,DEN,17,10,7,571.0,14,4,6,0.286,31,0.452,0,0.452,10.6,44,3,18,0.068,50,0.88,5,0.978,9.9,58,7,24,0.121,81,0.716,5,0.763,10.1
139,1629018,Gary Trent Jr.,1610612757,POR,2,1,1,13.0,0,0,0,0.0,1,0.0,0,0.0,0.0,3,0,1,0.0,3,1.0,1,1.5,4.3,3,0,1,0.0,4,0.75,1,1.0,4.3
140,201588,George Hill,1610612739,CLE,10,1,9,265.0,8,4,3,0.5,15,0.533,1,0.571,9.3,11,1,3,0.091,14,0.786,2,0.917,10.1,19,5,6,0.263,28,0.679,3,0.76,9.6
141,1627777,Georges Niang,1610612762,UTA,15,8,7,119.0,3,0,3,0.0,5,0.6,0,0.6,18.1,18,4,10,0.222,24,0.75,0,0.75,5.5,21,4,13,0.19,29,0.724,0,0.724,7.6
142,101123,Gerald Green,1610612745,HOU,13,6,7,220.0,8,3,5,0.375,14,0.571,0,0.571,15.5,24,0,17,0.0,42,0.571,2,0.6,7.4,32,3,22,0.094,55,0.582,2,0.604,9.1
143,203507,Giannis Antetokounmpo,1610612749,MIL,15,11,4,497.0,39,24,12,0.615,81,0.481,1,0.488,6.8,151,39,91,0.258,189,0.799,10,0.844,4.7,190,63,103,0.332,257,0.739,11,0.772,5.1
144,203922,Glenn Robinson III,1610612765,DET,13,7,6,226.0,2,0,2,0.0,13,0.154,1,0.167,11.6,18,0,10,0.0,22,0.818,1,0.857,7.5,20,0,12,0.0,34,0.588,2,0.625,8.1
145,201609,Goran Dragic,1610612748,MIA,12,5,7,369.0,8,2,6,0.25,23,0.348,1,0.364,13.4,32,2,18,0.063,51,0.627,7,0.727,10.8,40,4,24,0.1,74,0.541,8,0.606,11.4
146,202330,Gordon Hayward,1610612738,BOS,16,8,8,432.0,17,5,11,0.294,37,0.459,1,0.472,10.3,70,10,42,0.143,106,0.66,5,0.693,7.0,87,15,53,0.172,137,0.635,6,0.664,7.6
147,203476,Gorgui Dieng,1610612750,MIN,17,7,10,225.0,17,10,7,0.588,38,0.447,1,0.459,9.1,59,15,29,0.254,78,0.756,6,0.819,4.8,76,25,36,0.329,112,0.679,7,0.724,5.9
148,1628960,Grayson Allen,1610612762,UTA,11,4,7,117.0,0,0,0,0.0,0,0.0,0,0.0,0.0,2,0,1,0.0,1,2.0,0,2.0,2.6,2,0,1,0.0,1,2.0,0,2.0,2.6
149,202328,Greg Monroe,1610612761,TOR,8,5,3,58.0,9,6,3,0.667,19,0.474,1,0.5,5.4,14,5,9,0.357,18,0.778,2,0.875,5.4,23,11,12,0.478,36,0.639,3,0.697,5.4
150,1627824,Guerschon Yabusele,1610612738,BOS,9,6,3,38.0,4,2,1,0.5,3,1.333,0,1.333,11.1,6,1,2,0.167,6,1.0,1,1.2,4.0,10,3,3,0.3,9,1.111,1,1.25,6.1
151,1628977,Hamidou Diallo,1610612760,OKC,15,9,6,216.0,17,13,4,0.765,31,0.548,0,0.548,4.8,21,3,8,0.143,21,1.0,0,1.0,4.4,38,16,12,0.421,52,0.731,0,0.731,4.8
152,203084,Harrison Barnes,1610612742,DAL,12,5,7,377.0,7,1,5,0.143,20,0.35,1,0.368,13.2,50,7,24,0.14,42,1.19,2,1.25,8.0,57,8,29,0.14,58,0.983,3,1.036,8.8
153,1628385,Harry Giles III,1610612758,SAC,13,6,7,131.0,12,8,3,0.667,26,0.462,0,0.462,5.1,27,6,12,0.222,51,0.529,5,0.587,5.5,39,14,15,0.359,72,0.542,5,0.582,4.9
154,202355,Hassan Whiteside,1610612748,MIA,15,5,10,421.0,57,37,13,0.649,124,0.46,4,0.475,5.2,159,35,79,0.22,218,0.729,10,0.764,4.4,216,72,92,0.333,329,0.657,14,0.686,4.6
155,1627740,Henry Ellenson,1610612765,DET,1,0,1,8.0,0,0,0,0.0,1,0.0,1,0.0,0.0,3,3,0,1.0,3,1.0,0,1.0,3.2,3,3,0,1.0,4,0.75,1,1.0,3.2
156,203546,Ian Clark,1610612740,NOP,16,9,7,269.0,3,1,2,0.333,6,0.5,0,0.5,9.7,25,1,13,0.04,26,0.962,3,1.087,9.8,28,2,15,0.071,32,0.875,3,0.966,9.8
157,101133,Ian Mahinmi,1610612764,WAS,11,4,7,161.0,18,12,6,0.667,35,0.514,0,0.514,6.9,24,3,11,0.125,43,0.558,5,0.632,6.2,42,15,17,0.357,77,0.545,5,0.583,6.7
158,1628387,Ike Anigbogu,1610612754,IND,1,1,0,3.0,0,0,0,0.0,2,0.0,0,0.0,0.0,1,0,1,0.0,1,1.0,0,1.0,8.1,1,0,1,0.0,3,0.333,0,0.333,8.1
159,202697,Iman Shumpert,1610612758,SAC,15,7,8,378.0,4,2,1,0.5,17,0.235,0,0.235,11.0,45,6,19,0.133,52,0.865,2,0.9,7.8,49,8,20,0.163,64,0.766,2,0.79,7.9
160,1628515,Isaiah Briscoe,1610612753,ORL,7,3,4,52.0,0,0,0,0.0,1,0.0,0,0.0,0.0,4,0,3,0.0,3,1.333,0,1.333,7.6,4,0,3,0.0,4,1.0,0,1.0,7.6
161,203477,Isaiah Canaan,1610612756,PHX,15,3,12,419.0,4,1,3,0.25,13,0.308,1,0.333,26.0,39,5,29,0.128,56,0.696,5,0.765,8.5,43,6,32,0.14,68,0.632,6,0.694,10.4
162,1628392,Isaiah Hartenstein,1610612745,HOU,14,7,7,127.0,13,10,3,0.769,39,0.333,1,0.342,6.1,13,3,6,0.231,27,0.481,2,0.52,11.3,26,13,9,0.5,66,0.394,3,0.413,8.0
163,202397,Ish Smith,1610612765,DET,14,8,6,366.0,1,1,0,1.0,5,0.2,1,0.25,7.8,29,6,11,0.207,44,0.659,5,0.744,8.2,30,7,11,0.233,48,0.625,6,0.714,8.3
164,1628397,Ivan Rabb,1610612763,MEM,8,6,2,53.0,4,4,0,1.0,10,0.4,0,0.4,4.6,14,2,9,0.143,16,0.875,2,1.0,4.8,18,6,9,0.333,25,0.72,2,0.783,4.7
165,1627826,Ivica Zubac,1610612747,LAL,5,3,2,40.0,9,6,2,0.667,16,0.563,0,0.563,6.8,10,3,2,0.3,9,1.111,1,1.25,2.1,19,9,4,0.474,23,0.826,1,0.864,5.2
166,200826,J.J. Barea,1610612742,DAL,15,7,8,282.0,7,0,6,0.0,14,0.5,1,0.538,11.5,28,2,14,0.071,30,0.933,2,1.0,8.6,35,2,20,0.057,44,0.795,3,0.854,9.6
167,200755,JJ Redick,1610612755,PHI,19,12,7,591.0,6,0,3,0.0,8,0.75,1,0.857,21.4,41,2,24,0.049,57,0.719,6,0.804,11.0,47,2,27,0.043,65,0.723,7,0.81,12.0
168,2747,JR Smith,1610612739,CLE,11,1,10,222.0,0,0,0,0.0,3,0.0,0,0.0,0.0,18,1,11,0.056,25,0.72,2,0.783,7.8,18,1,11,0.056,25,0.72,2,0.783,7.8
169,203210,JaMychal Green,1610612763,MEM,4,3,1,75.0,11,7,4,0.636,30,0.367,0,0.367,4.8,18,4,14,0.222,27,0.667,1,0.692,4.5,29,11,18,0.379,53,0.547,1,0.558,4.6
170,201580,JaVale McGee,1610612747,LAL,16,9,7,400.0,44,32,9,0.727,82,0.537,1,0.543,5.2,63,22,30,0.349,120,0.525,9,0.568,4.1,107,54,39,0.505,199,0.538,10,0.566,4.5
171,203953,Jabari Parker,1610612741,CHI,17,4,13,521.0,17,12,3,0.706,50,0.34,1,0.347,7.9,95,22,51,0.232,141,0.674,9,0.72,5.1,112,34,54,0.304,182,0.615,10,0.651,5.6
172,1628980,Jacob Evans,1610612744,GSW,10,8,2,60.0,1,0,1,0.0,2,0.5,0,0.5,10.3,6,0,4,0.0,6,1.0,0,1.0,5.4,7,0,5,0.0,8,0.875,0,0.875,6.4
173,203109,Jae Crowder,1610612762,UTA,17,8,9,493.0,13,6,7,0.462,36,0.361,1,0.371,12.3,75,12,30,0.16,87,0.862,4,0.904,6.2,88,18,37,0.205,116,0.759,5,0.793,7.4
174,1626143,Jahlil Okafor,1610612740,NOP,8,4,4,59.0,10,7,2,0.7,19,0.526,0,0.526,2.5,8,3,3,0.375,12,0.667,0,0.667,6.2,18,10,5,0.556,31,0.581,0,0.581,3.9
175,1627774,Jake Layman,1610612757,POR,16,11,5,254.0,11,5,5,0.455,15,0.733,1,0.786,11.1,29,5,14,0.172,38,0.763,0,0.763,8.9,40,10,19,0.25,52,0.769,1,0.784,9.7
176,1627751,Jakob Poeltl,1610612759,SAS,12,4,8,135.0,29,21,6,0.724,49,0.592,2,0.617,5.4,21,10,8,0.476,39,0.538,6,0.636,4.2,50,31,14,0.62,86,0.581,8,0.641,4.9
177,1628973,Jalen Brunson,1610612742,DAL,15,6,9,208.0,3,1,2,0.333,13,0.231,1,0.25,4.8,20,5,7,0.25,23,0.87,0,0.87,7.4,23,6,9,0.261,35,0.657,1,0.676,6.7
178,2037,Jamal Crawford,1610612756,PHX,14,2,12,166.0,1,0,0,0.0,2,0.5,0,0.5,0.0,10,0,6,0.0,10,1.0,1,1.111,8.5,11,0,6,0.0,11,1.0,1,1.1,8.5
179,1627750,Jamal Murray,1610612743,DEN,17,10,7,560.0,14,6,6,0.429,29,0.483,3,0.538,10.5,57,5,33,0.088,78,0.731,3,0.76,9.4,71,11,39,0.155,106,0.67,6,0.71,9.5
180,203516,James Ennis III,1610612745,HOU,12,8,4,292.0,13,7,6,0.538,36,0.361,1,0.371,7.7,16,0,9,0.0,42,0.381,5,0.432,5.8,29,7,15,0.241,76,0.382,6,0.414,6.9
181,201935,James Harden,1610612745,HOU,12,7,5,430.0,6,2,4,0.333,27,0.222,0,0.222,11.0,57,8,39,0.14,83,0.687,6,0.74,7.7,63,10,43,0.159,102,0.618,6,0.656,8.1
182,201949,James Johnson,1610612748,MIA,1,0,1,15.0,0,0,0,0.0,0,0.0,0,0.0,0.0,0,0,0,0.0,0,0.0,0,0.0,0.0,0,0,0,0.0,0,0.0,0,0.0,0.0
183,203263,James Nunnally,1610612750,MIN,6,2,4,40.0,0,0,0,0.0,2,0.0,1,0.0,0.0,3,0,3,0.0,4,0.75,1,1.0,5.1,3,0,3,0.0,5,0.6,2,1.0,5.1
184,201162,Jared Dudley,1610612751,BKN,17,7,10,415.0,14,7,4,0.5,23,0.609,0,0.609,7.0,40,7,15,0.175,82,0.488,5,0.519,4.7,54,14,19,0.259,102,0.529,5,0.557,5.2
185,1629123,Jared Terrell,1610612750,MIN,1,0,1,21.0,0,0,0,0.0,0,0.0,0,0.0,0.0,1,0,0,0.0,0,0.0,0,0.0,0.0,1,0,0,0.0,0,0.0,0,0.0,0.0
186,1626185,Jarell Martin,1610612753,ORL,10,5,5,118.0,4,0,4,0.0,12,0.333,1,0.364,8.8,20,3,8,0.15,29,0.69,1,0.714,5.3,24,3,12,0.125,41,0.585,2,0.615,5.5
187,1628991,Jaren Jackson Jr.,1610612763,MEM,16,11,5,404.0,24,18,5,0.75,60,0.4,1,0.407,4.8,49,12,13,0.245,90,0.544,5,0.576,6.0,73,30,18,0.411,148,0.493,6,0.514,5.5
188,1628386,Jarrett Allen,1610612751,BKN,15,7,8,403.0,43,24,13,0.558,89,0.483,3,0.5,5.5,82,14,37,0.171,156,0.526,14,0.577,4.6,125,38,50,0.304,240,0.521,17,0.561,4.9
189,201160,Jason Smith,1610612764,WAS,10,3,7,111.0,11,7,4,0.636,26,0.423,0,0.423,5.8,22,5,10,0.227,32,0.688,2,0.733,4.1,33,12,14,0.364,56,0.589,2,0.611,4.8
190,1629121,Jaylen Adams,1610612737,ATL,4,1,3,13.0,0,0,0,0.0,0,0.0,0,0.0,0.0,2,0,1,0.0,2,1.0,1,2.0,7.6,2,0,1,0.0,2,1.0,1,2.0,7.6
191,1627759,Jaylen Brown,1610612738,BOS,16,8,8,455.0,20,8,9,0.4,38,0.526,0,0.526,9.9,46,7,24,0.152,77,0.597,8,0.667,4.7,66,15,33,0.227,114,0.579,8,0.623,6.2
192,1628537,Jaylen Morris,1610612749,MIL,1,1,0,3.0,0,0,0,0.0,0,0.0,0,0.0,0.0,1,0,0,0.0,0,0.0,1,-1.0,0.0,1,0,0,0.0,0,0.0,1,-1.0,0.0
193,1628369,Jayson Tatum,1610612738,BOS,17,9,8,547.0,23,11,10,0.478,41,0.561,1,0.575,10.9,94,20,57,0.213,133,0.707,6,0.74,6.3,117,31,67,0.265,168,0.696,7,0.727,7.1
194,201145,Jeff Green,1610612764,WAS,16,5,11,392.0,27,17,9,0.63,41,0.659,0,0.659,5.8,57,9,25,0.158,75,0.76,7,0.838,8.3,84,26,34,0.31,112,0.75,7,0.8,7.3
195,201952,Jeff Teague,1610612750,MIN,11,6,5,350.0,2,2,0,1.0,17,0.118,2,0.133,6.2,24,3,16,0.125,43,0.558,4,0.615,10.4,26,5,16,0.192,60,0.433,6,0.481,10.0
196,203924,Jerami Grant,1610612760,OKC,16,10,6,476.0,14,9,3,0.643,46,0.304,1,0.311,6.2,66,8,40,0.121,102,0.647,8,0.702,7.1,80,17,43,0.213,138,0.58,9,0.62,7.1
197,203087,Jeremy Lamb,1610612766,CHA,16,8,8,416.0,12,4,7,0.333,37,0.324,1,0.333,8.0,68,13,48,0.191,111,0.613,8,0.66,5.6,80,17,55,0.213,143,0.559,9,0.597,5.9
198,202391,Jeremy Lin,1610612737,ATL,17,3,14,301.0,4,0,4,0.0,12,0.333,0,0.333,21.6,30,4,18,0.133,40,0.75,2,0.789,7.8,34,4,22,0.118,51,0.667,2,0.694,9.0
199,1626170,Jerian Grant,1610612753,ORL,17,9,8,327.0,9,4,4,0.444,19,0.474,1,0.5,17.6,25,3,17,0.12,45,0.556,7,0.658,7.8,34,7,21,0.206,61,0.557,8,0.642,10.5
200,1629010,Jerome Robinson,1610612746,LAC,8,5,3,40.0,0,0,0,0.0,0,0.0,1,0.0,0.0,3,1,1,0.333,5,0.6,0,0.6,10.8,3,1,1,0.333,5,0.6,1,0.75,10.8
201,202710,Jimmy Butler,1610612755,PHI,14,6,8,501.0,19,13,5,0.684,37,0.514,3,0.559,10.4,46,6,31,0.13,69,0.667,6,0.73,7.7,65,19,36,0.292,106,0.613,9,0.67,8.6
202,203925,Joe Harris,1610612751,BKN,17,7,10,494.0,12,6,4,0.5,32,0.375,2,0.4,9.8,45,8,17,0.178,78,0.577,9,0.652,6.6,57,14,21,0.246,106,0.538,11,0.6,7.6
203,204060,Joe Ingles,1610612762,UTA,17,8,9,558.0,6,2,4,0.333,17,0.353,0,0.353,13.1,61,8,28,0.131,80,0.763,4,0.803,7.5,67,10,32,0.149,97,0.691,4,0.72,7.5
204,203954,Joel Embiid,1610612755,PHI,19,12,7,664.0,42,24,13,0.571,133,0.316,2,0.321,5.5,207,38,91,0.184,284,0.729,21,0.787,4.6,249,62,104,0.249,409,0.609,23,0.645,4.7
205,1628381,John Collins,1610612737,ATL,2,0,2,33.0,3,2,0,0.667,7,0.429,0,0.429,3.4,2,0,1,0.0,5,0.4,1,0.5,5.9,5,2,1,0.4,12,0.417,1,0.455,4.3
206,203089,John Henson,1610612749,MIL,14,10,4,188.0,16,9,4,0.563,42,0.381,1,0.39,9.2,55,10,33,0.182,79,0.696,6,0.753,5.5,71,19,37,0.268,114,0.623,7,0.664,6.0
207,204066,John Holland,1610612739,CLE,1,0,1,1.0,0,0,0,0.0,0,0.0,0,0.0,0.0,0,0,0,0.0,0,0.0,0,0.0,0.0,0,0,0,0.0,0,0.0,0,0.0,0.0
208,202322,John Wall,1610612764,WAS,16,5,11,557.0,10,1,9,0.1,34,0.294,0,0.294,12.9,43,4,24,0.093,61,0.705,9,0.827,8.2,53,5,33,0.094,95,0.558,9,0.616,9.3
209,1629140,Johnathan Williams,1610612747,LAL,6,3,3,85.0,11,5,5,0.455,22,0.5,0,0.5,4.7,10,4,6,0.4,19,0.526,0,0.526,6.5,21,9,11,0.429,39,0.538,0,0.538,5.6
210,202720,Jon Leuer,1610612765,DET,6,3,3,46.0,4,2,2,0.5,6,0.667,0,0.667,3.2,10,2,2,0.2,12,0.833,1,0.909,4.4,14,4,4,0.286,18,0.778,1,0.824,4.9
211,1628413,Jonah Bolden,1610612755,PHI,6,3,3,40.0,0,0,0,0.0,8,0.0,0,0.0,0.0,9,3,5,0.333,10,0.9,1,1.0,3.6,9,3,5,0.333,15,0.6,1,0.643,3.6
212,201973,Jonas Jerebko,1610612744,GSW,18,12,6,332.0,26,11,12,0.423,56,0.464,1,0.473,7.4,67,15,21,0.224,98,0.684,10,0.761,6.0,93,26,33,0.28,148,0.628,11,0.679,6.0
213,202685,Jonas Valanciunas,1610612761,TOR,17,13,4,324.0,33,21,7,0.636,66,0.5,2,0.516,3.5,93,26,36,0.28,126,0.738,9,0.795,3.5,126,47,43,0.373,184,0.685,11,0.728,3.4
214,1628371,Jonathan Isaac,1610612753,ORL,11,5,6,233.0,15,13,1,0.867,32,0.469,1,0.484,5.5,44,13,28,0.295,66,0.667,7,0.746,3.9,59,26,29,0.441,98,0.602,8,0.656,4.3
215,203613,Jonathon Simmons,1610612753,ORL,15,9,6,340.0,10,5,4,0.5,24,0.417,0,0.417,9.3,31,5,18,0.161,57,0.544,7,0.62,6.8,41,10,22,0.244,79,0.519,7,0.569,7.1
216,1628395,Jordan Bell,1610612744,GSW,17,11,6,197.0,9,5,4,0.556,25,0.36,1,0.375,9.6,34,7,16,0.206,50,0.68,5,0.756,4.2,43,12,20,0.279,70,0.614,6,0.672,5.5
217,203903,Jordan Clarkson,1610612739,CLE,15,2,13,365.0,14,8,5,0.571,24,0.583,2,0.636,12.1,34,3,22,0.088,54,0.63,3,0.667,7.4,48,11,27,0.229,76,0.632,5,0.676,8.2
218,1628070,Jordan Loyd,1610612761,TOR,2,1,1,14.0,1,1,0,1.0,1,1.0,0,1.0,6.6,4,2,2,0.5,7,0.571,1,0.667,3.8,5,3,2,0.6,8,0.625,1,0.714,4.3
219,203895,Jordan McRae,1610612764,WAS,4,1,3,22.0,0,0,0,0.0,0,0.0,0,0.0,0.0,4,1,3,0.25,6,0.667,0,0.667,7.0,4,1,3,0.25,6,0.667,0,0.667,7.0
220,101181,Jose Calderon,1610612765,DET,11,5,6,125.0,3,1,0,0.333,4,0.75,0,0.75,2.5,7,0,4,0.0,10,0.7,0,0.7,5.1,10,1,4,0.1,14,0.714,0,0.714,4.6
221,1628404,Josh Hart,1610612747,LAL,16,9,7,422.0,8,2,6,0.25,22,0.364,0,0.364,17.1,54,9,33,0.167,75,0.72,11,0.844,6.9,62,11,39,0.177,95,0.653,11,0.738,8.3
222,1628367,Josh Jackson,1610612756,PHX,16,3,13,276.0,3,2,0,0.667,10,0.3,0,0.3,6.9,30,6,19,0.2,45,0.667,4,0.732,7.9,33,8,19,0.242,54,0.611,4,0.66,7.7
223,1629006,Josh Okogie,1610612750,MIN,14,6,8,327.0,12,9,3,0.75,22,0.545,0,0.545,6.9,42,3,24,0.071,59,0.712,6,0.792,7.3,54,12,27,0.222,81,0.667,6,0.72,7.1
224,1626196,Josh Richardson,1610612748,MIA,16,6,10,556.0,14,3,10,0.214,40,0.35,3,0.378,9.7,50,2,30,0.04,77,0.649,10,0.746,9.6,64,5,40,0.078,117,0.547,13,0.615,9.5
225,201950,Jrue Holiday,1610612740,NOP,17,10,7,611.0,18,9,8,0.5,47,0.383,3,0.409,9.3,56,8,28,0.143,76,0.737,5,0.789,9.2,74,17,36,0.23,122,0.607,8,0.649,9.0
226,1627823,Juancho Hernangomez,1610612743,DEN,16,9,7,376.0,28,11,13,0.393,45,0.622,2,0.651,7.7,54,2,21,0.037,72,0.75,2,0.771,6.0,82,13,34,0.159,112,0.732,4,0.759,6.4
227,203944,Julius Randle,1610612740,NOP,17,10,7,435.0,40,26,10,0.65,89,0.449,5,0.476,5.0,105,22,58,0.21,138,0.761,8,0.808,4.2,145,48,68,0.331,214,0.678,13,0.721,4.5
228,1626147,Justin Anderson,1610612737,ATL,1,0,1,3.0,0,0,0,0.0,0,0.0,0,0.0,0.0,0,0,0,0.0,0,0.0,0,0.0,0.0,0,0,0,0.0,0,0.0,0,0.0,0.0
229,203200,Justin Holiday,1610612741,CHI,17,4,13,594.0,5,2,3,0.4,11,0.455,0,0.455,12.0,57,8,32,0.14,85,0.671,9,0.75,7.8,62,10,35,0.161,94,0.66,9,0.729,8.2
230,1628382,Justin Jackson,1610612758,SAC,16,9,7,341.0,5,0,4,0.0,9,0.556,0,0.556,6.9,39,3,21,0.077,37,1.054,4,1.182,9.1,44,3,25,0.068,45,0.978,4,1.073,8.7
231,1626159,Justise Winslow,1610612748,MIA,12,4,8,337.0,15,4,9,0.267,43,0.349,3,0.375,12.4,49,8,15,0.163,82,0.598,8,0.662,4.9,64,12,24,0.188,121,0.529,11,0.582,7.6
232,203994,Jusuf Nurkic,1610612757,POR,16,11,5,413.0,64,43,15,0.672,124,0.516,8,0.552,4.3,111,23,53,0.207,179,0.62,17,0.685,4.0,175,66,68,0.377,298,0.587,25,0.641,4.2
233,1626157,Karl-Anthony Towns,1610612750,MIN,17,7,10,577.0,51,27,24,0.529,114,0.447,1,0.451,7.6,156,32,69,0.205,227,0.687,11,0.722,4.8,207,59,93,0.285,331,0.625,12,0.649,5.6
234,202695,Kawhi Leonard,1610612761,TOR,12,9,3,403.0,16,6,8,0.375,39,0.41,1,0.421,14.7,85,17,43,0.2,105,0.81,5,0.85,7.0,101,23,51,0.228,137,0.737,6,0.771,8.3
235,1628966,Keita Bates-Diop,1610612750,MIN,2,0,2,18.0,0,0,0,0.0,0,0.0,0,0.0,0.0,3,1,0,0.333,3,1.0,0,1.0,11.3,3,1,0,0.333,3,1.0,0,1.0,11.3
236,203482,Kelly Olynyk,1610612748,MIA,16,6,10,289.0,13,8,3,0.615,25,0.52,1,0.542,6.7,43,6,22,0.14,56,0.768,3,0.811,5.7,56,14,25,0.25,79,0.709,4,0.747,6.0
237,1626162,Kelly Oubre Jr.,1610612764,WAS,16,5,11,412.0,11,8,2,0.727,47,0.234,4,0.256,7.7,61,11,33,0.18,86,0.709,2,0.726,5.0,72,19,35,0.264,127,0.567,6,0.595,5.2
238,202689,Kemba Walker,1610612766,CHA,16,8,8,564.0,6,2,3,0.333,37,0.162,0,0.162,14.0,65,17,41,0.262,110,0.591,7,0.631,9.5,71,19,44,0.268,144,0.493,7,0.518,9.8
239,202702,Kenneth Faried,1610612751,BKN,6,2,4,35.0,6,2,1,0.333,3,2.0,0,2.0,7.3,8,1,3,0.125,5,1.6,0,1.6,7.6,14,3,4,0.214,7,2.0,0,2.0,7.5
240,1629026,Kenrich Williams,1610612740,NOP,5,3,2,27.0,0,0,0,0.0,0,0.0,0,0.0,0.0,5,1,4,0.2,7,0.714,2,1.0,6.1,5,1,4,0.2,7,0.714,2,1.0,6.1
241,203145,Kent Bazemore,1610612737,ATL,17,3,14,476.0,13,4,9,0.308,35,0.371,2,0.394,14.0,59,8,34,0.136,97,0.608,8,0.663,6.0,72,12,43,0.167,129,0.558,10,0.605,7.5
242,203484,Kentavious Caldwell-Pope,1610612747,LAL,16,9,7,315.0,7,3,4,0.429,17,0.412,0,0.412,10.6,28,3,19,0.107,35,0.8,1,0.824,6.2,35,6,23,0.171,52,0.673,1,0.686,7.3
243,201142,Kevin Durant,1610612744,GSW,18,12,6,626.0,6,3,3,0.5,36,0.167,4,0.188,8.0,123,17,63,0.138,139,0.885,8,0.939,5.9,129,20,66,0.155,161,0.801,12,0.866,6.0
244,1628989,Kevin Huerter,1610612737,ATL,16,3,13,298.0,8,2,5,0.25,19,0.421,2,0.471,10.6,42,3,31,0.071,51,0.824,3,0.875,6.6,50,5,36,0.1,70,0.714,5,0.769,7.3
245,1628995,Kevin Knox,1610612752,NYK,10,2,8,193.0,10,4,6,0.4,17,0.588,2,0.667,8.0,12,1,10,0.083,21,0.571,0,0.571,7.4,22,5,16,0.227,38,0.579,2,0.611,7.7
246,201567,Kevin Love,1610612739,CLE,4,0,4,136.0,10,7,3,0.7,28,0.357,1,0.37,5.7,44,7,25,0.159,42,1.048,2,1.1,3.7,54,14,28,0.259,69,0.783,3,0.818,4.2
247,1626172,Kevon Looney,1610612744,GSW,18,12,6,331.0,43,24,17,0.558,82,0.524,2,0.538,5.5,47,11,21,0.234,86,0.547,6,0.588,5.1,90,35,38,0.389,164,0.549,8,0.577,5.2
248,203920,Khem Birch,1610612753,ORL,6,2,4,34.0,3,1,1,0.333,6,0.5,1,0.6,4.2,8,0,4,0.0,6,1.333,0,1.333,5.9,11,1,5,0.091,11,1.0,1,1.1,5.3
249,203114,Khris Middleton,1610612749,MIL,16,12,4,500.0,9,6,3,0.667,32,0.281,2,0.3,9.3,77,9,48,0.117,111,0.694,6,0.733,7.1,86,15,51,0.174,143,0.601,8,0.637,7.5
250,1629017,Khyri Thomas,1610612765,DET,2,2,0,11.0,0,0,0,0.0,0,0.0,0,0.0,0.0,1,0,1,0.0,1,1.0,0,1.0,5.6,1,0,1,0.0,1,1.0,0,1.0,5.6
251,202691,Klay Thompson,1610612744,GSW,18,12,6,614.0,8,2,6,0.25,23,0.348,1,0.364,20.2,55,6,29,0.109,82,0.671,10,0.764,8.4,63,8,35,0.127,102,0.618,11,0.692,10.3
252,201585,Kosta Koufos,1610612758,SAC,7,4,3,98.0,8,2,4,0.25,22,0.364,0,0.364,6.2,30,8,14,0.267,42,0.714,1,0.732,4.1,38,10,18,0.263,56,0.679,1,0.691,4.5
253,1627739,Kris Dunn,1610612741,CHI,1,0,1,30.0,0,0,0,0.0,0,0.0,0,0.0,0.0,4,0,4,0.0,6,0.667,0,0.667,7.9,4,0,4,0.0,6,0.667,0,0.667,7.9
254,203937,Kyle Anderson,1610612763,MEM,16,11,5,462.0,19,8,11,0.421,48,0.396,0,0.396,8.1,84,15,38,0.179,103,0.816,6,0.866,7.1,103,23,49,0.223,144,0.715,6,0.746,7.0
255,2594,Kyle Korver,1610612739,CLE,12,1,11,187.0,0,0,0,0.0,1,0.0,0,0.0,0.0,19,1,11,0.053,23,0.826,3,0.95,6.7,19,1,11,0.053,24,0.792,3,0.905,6.7
256,1628398,Kyle Kuzma,1610612747,LAL,16,9,7,486.0,11,7,4,0.636,42,0.262,3,0.282,6.7,65,10,44,0.154,104,0.625,11,0.699,6.2,76,17,48,0.224,142,0.535,14,0.594,6.3
257,200768,Kyle Lowry,1610612761,TOR,17,13,4,578.0,10,4,5,0.4,39,0.256,1,0.263,10.3,62,10,36,0.161,103,0.602,4,0.626,7.8,72,14,41,0.194,142,0.507,5,0.526,8.0
258,203124,Kyle O'Quinn,1610612754,IND,10,6,4,55.0,8,5,2,0.625,16,0.5,1,0.533,2.4,15,4,4,0.267,15,1.0,1,1.071,3.9,23,9,6,0.391,31,0.742,2,0.793,3.2
259,202681,Kyrie Irving,1610612738,BOS,16,9,7,522.0,16,11,4,0.688,42,0.381,1,0.39,13.7,62,10,33,0.161,94,0.66,6,0.705,7.3,78,21,37,0.269,135,0.578,7,0.609,8.8
260,200746,LaMarcus Aldridge,1610612759,SAS,16,8,8,562.0,62,48,11,0.774,133,0.466,4,0.481,4.9,120,29,64,0.242,179,0.67,13,0.723,5.4,182,77,75,0.423,307,0.593,17,0.628,5.2
261,202362,Lance Stephenson,1610612747,LAL,16,9,7,264.0,9,5,3,0.556,23,0.391,0,0.391,5.7,49,9,33,0.184,70,0.7,7,0.778,7.5,58,14,36,0.241,93,0.624,7,0.674,7.3
262,202498,Lance Thomas,1610612752,NYK,11,3,8,167.0,4,2,2,0.5,10,0.4,1,0.444,5.2,20,2,12,0.1,20,1.0,1,1.053,5.5,24,4,14,0.167,30,0.8,2,0.857,5.7
263,1629013,Landry Shamet,1610612755,PHI,19,12,7,398.0,4,1,3,0.25,5,0.8,1,1.0,19.8,16,1,6,0.063,13,1.231,0,1.231,9.2,20,2,9,0.1,18,1.111,1,1.176,13.0
264,204038,Langston Galloway,1610612765,DET,13,8,5,323.0,8,3,5,0.375,16,0.5,0,0.5,13.9,29,0,18,0.0,32,0.906,2,0.967,10.3,37,3,23,0.081,45,0.822,2,0.86,11.3
265,1626204,Larry Nance Jr.,1610612739,CLE,13,2,11,287.0,25,16,8,0.64,55,0.455,2,0.472,6.5,59,8,34,0.136,93,0.634,5,0.67,5.2,84,24,42,0.286,143,0.587,7,0.618,5.6
266,2544,LeBron James,1610612747,LAL,16,9,7,555.0,16,11,3,0.688,46,0.348,4,0.381,7.9,107,25,64,0.234,160,0.669,7,0.699,6.4,123,36,67,0.293,197,0.624,11,0.661,6.7
267,1628366,Lonzo Ball,1610612747,LAL,16,9,7,416.0,16,9,4,0.563,41,0.39,3,0.421,6.8,63,13,38,0.206,80,0.788,8,0.875,5.7,79,22,42,0.278,120,0.658,11,0.725,5.9
268,203485,Lorenzo Brown,1610612761,TOR,11,9,2,99.0,1,0,1,0.0,2,0.5,0,0.5,8.6,12,1,9,0.083,15,0.8,0,0.8,6.5,13,1,10,0.077,17,0.765,0,0.765,6.7
269,101150,Lou Williams,1610612746,LAC,16,11,5,428.0,7,2,4,0.286,17,0.412,1,0.438,9.3,34,5,16,0.147,45,0.756,7,0.895,11.4,41,7,20,0.171,61,0.672,8,0.774,10.7
270,201601,Luc Mbah a Moute,1610612746,LAC,4,2,2,61.0,2,1,1,0.5,7,0.286,0,0.286,9.4,5,1,2,0.2,10,0.5,1,0.556,6.6,7,2,3,0.286,17,0.412,1,0.438,6.4
271,1629029,Luka Doncic,1610612742,DAL,16,7,9,542.0,17,8,8,0.471,47,0.362,0,0.362,10.3,92,12,55,0.13,131,0.702,5,0.73,6.9,109,20,63,0.183,175,0.623,5,0.641,7.3
272,1628379,Luke Kennard,1610612765,DET,3,3,0,43.0,0,0,0,0.0,2,0.0,0,0.0,0.0,5,2,3,0.4,6,0.833,0,0.833,8.9,5,2,3,0.4,8,0.625,0,0.625,8.9
273,1628436,Luke Kornet,1610612752,NYK,4,1,3,13.0,0,0,0,0.0,0,0.0,0,0.0,0.0,0,0,0,0.0,0,0.0,0,0.0,0.0,0,0,0,0.0,0,0.0,0,0.0,0.0
274,2736,Luol Deng,1610612750,MIN,2,0,2,19.0,5,2,3,0.4,7,0.714,0,0.714,8.6,5,1,1,0.2,4,1.25,0,1.25,4.7,10,3,4,0.3,11,0.909,0,0.909,5.6
275,1627781,Malachi Richardson,1610612761,TOR,10,7,3,64.0,1,0,0,0.0,1,1.0,0,1.0,0.0,8,1,7,0.125,11,0.727,1,0.8,6.3,9,1,7,0.111,12,0.75,1,0.818,6.3
276,1627763,Malcolm Brogdon,1610612749,MIL,16,12,4,480.0,15,7,7,0.467,30,0.5,0,0.5,13.1,53,9,33,0.17,73,0.726,6,0.791,7.7,68,16,40,0.235,103,0.66,6,0.701,8.7
277,1627736,Malik Beasley,1610612743,DEN,17,10,7,304.0,3,1,2,0.333,10,0.3,1,0.333,8.5,36,3,14,0.083,31,1.161,3,1.286,6.2,39,4,16,0.103,38,1.026,4,1.147,6.6
278,1628370,Malik Monk,1610612766,CHA,16,8,8,344.0,5,3,2,0.6,19,0.263,1,0.278,14.9,25,3,19,0.12,36,0.694,2,0.735,11.0,30,6,21,0.2,54,0.556,3,0.588,11.7
279,202705,MarShon Brooks,1610612763,MEM,15,10,5,211.0,8,6,2,0.75,19,0.421,1,0.444,6.0,22,2,17,0.091,29,0.759,0,0.759,8.4,30,8,19,0.267,46,0.652,1,0.667,7.7
280,201188,Marc Gasol,1610612763,MEM,16,11,5,550.0,24,18,6,0.75,43,0.558,2,0.585,7.9,129,26,63,0.202,165,0.782,10,0.832,4.3,153,44,69,0.288,202,0.757,12,0.805,4.8
281,101162,Marcin Gortat,1610612746,LAC,13,9,4,226.0,21,15,5,0.714,51,0.412,0,0.412,4.7,55,12,29,0.218,78,0.705,7,0.775,4.4,76,27,34,0.355,128,0.594,7,0.628,4.5
282,201158,Marco Belinelli,1610612759,SAS,16,8,8,364.0,4,0,4,0.0,16,0.25,0,0.25,18.9,26,3,16,0.115,43,0.605,2,0.634,7.5,30,3,20,0.1,56,0.536,2,0.556,9.2
283,1629094,Marcus Derrickson,1610612744,GSW,2,1,1,8.0,0,0,0,0.0,1,0.0,0,0.0,0.0,1,1,0,1.0,1,1.0,0,1.0,8.1,1,1,0,1.0,1,1.0,0,1.0,8.1
284,202694,Marcus Morris,1610612738,BOS,16,8,8,413.0,11,4,5,0.364,36,0.306,0,0.306,8.1,94,12,60,0.128,130,0.723,3,0.74,5.8,105,16,65,0.152,156,0.673,3,0.686,5.9
285,203935,Marcus Smart,1610612738,BOS,17,9,8,396.0,9,4,4,0.444,27,0.333,0,0.333,8.0,37,8,19,0.216,52,0.712,2,0.74,8.4,46,12,23,0.261,77,0.597,2,0.613,8.2
286,1626209,Mario Hezonja,1610612752,NYK,15,4,11,297.0,4,2,2,0.5,21,0.19,0,0.19,5.3,54,5,31,0.093,74,0.73,6,0.794,4.9,58,7,33,0.121,88,0.659,6,0.707,4.9
287,1628365,Markelle Fultz,1610612755,PHI,19,12,7,427.0,26,15,8,0.577,50,0.52,2,0.542,6.8,44,4,24,0.091,70,0.629,2,0.647,8.5,70,19,32,0.271,119,0.588,4,0.609,7.8
288,202693,Markieff Morris,1610612764,WAS,15,5,10,377.0,12,9,2,0.75,21,0.571,0,0.571,6.3,53,13,20,0.245,96,0.552,5,0.582,5.6,65,22,22,0.338,115,0.565,5,0.591,5.7
289,1627737,Marquese Chriss,1610612745,HOU,5,3,2,24.0,1,1,0,1.0,1,1.0,0,1.0,2.1,3,0,1,0.0,2,1.5,0,1.5,4.8,4,1,1,0.25,3,1.333,0,1.333,3.4
290,1628963,Marvin Bagley III,1610612758,SAC,17,9,8,388.0,44,29,8,0.659,81,0.543,0,0.543,5.4,60,9,23,0.15,74,0.811,2,0.833,6.7,104,38,31,0.365,149,0.698,2,0.707,6.0
291,101107,Marvin Williams,1610612766,CHA,16,8,8,380.0,11,4,7,0.364,28,0.393,2,0.423,15.8,60,12,44,0.2,112,0.536,12,0.6,7.1,71,16,51,0.225,139,0.511,14,0.568,8.5
292,203486,Mason Plumlee,1610612743,DEN,17,10,7,281.0,31,15,12,0.484,70,0.443,3,0.463,9.1,46,10,17,0.217,74,0.622,5,0.667,4.2,77,25,29,0.325,142,0.542,8,0.575,6.7
293,203521,Matthew Dellavedova,1610612749,MIL,7,7,0,43.0,0,0,0,0.0,0,0.0,0,0.0,0.0,7,0,6,0.0,6,1.167,2,1.75,9.9,7,0,6,0.0,6,1.167,2,1.75,9.9
294,203090,Maurice Harkless,1610612757,POR,5,3,2,88.0,3,2,1,0.667,8,0.375,0,0.375,5.0,21,5,8,0.238,21,1.0,1,1.05,3.8,24,7,9,0.292,27,0.889,1,0.923,4.2
295,1628467,Maxi Kleber,1610612742,DAL,16,7,9,295.0,16,10,5,0.625,37,0.432,2,0.457,8.8,42,10,13,0.238,74,0.568,9,0.646,4.5,58,20,18,0.345,107,0.542,11,0.604,5.7
296,1628982,Melvin Frazier Jr.,1610612753,ORL,2,1,1,11.0,0,0,0,0.0,0,0.0,0,0.0,0.0,0,0,0,0.0,0,0.0,0,0.0,0.0,0,0,0,0.0,0,0.0,0,0.0,0.0
297,203086,Meyers Leonard,1610612757,POR,13,9,4,139.0,12,8,3,0.667,25,0.48,1,0.5,5.9,40,5,17,0.125,43,0.93,1,0.952,4.7,52,13,20,0.25,66,0.788,2,0.813,5.0
298,201563,Michael Beasley,1610612747,LAL,4,1,3,19.0,2,2,0,1.0,3,0.667,0,0.667,6.4,2,0,1,0.0,1,2.0,0,2.0,3.7,4,2,1,0.5,4,1.0,0,1.0,5.5
299,203487,Michael Carter-Williams,1610612745,HOU,9,4,5,102.0,2,1,1,0.5,4,0.5,0,0.5,4.4,9,4,4,0.444,13,0.692,1,0.75,6.7,11,5,5,0.455,17,0.647,1,0.688,6.2
300,203077,Michael Kidd-Gilchrist,1610612766,CHA,13,7,6,265.0,29,16,13,0.552,65,0.446,2,0.46,6.3,48,19,22,0.396,91,0.527,3,0.545,5.5,77,35,35,0.455,153,0.503,5,0.52,5.8
301,1628969,Mikal Bridges,1610612756,PHX,16,3,13,318.0,3,2,1,0.667,7,0.429,1,0.5,19.6,22,1,14,0.045,32,0.688,5,0.815,7.9,25,3,15,0.12,39,0.641,6,0.758,8.7
302,201144,Mike Conley,1610612763,MEM,16,11,5,534.0,7,2,4,0.286,16,0.438,0,0.438,16.0,44,4,24,0.091,52,0.846,4,0.917,8.9,51,6,28,0.118,68,0.75,4,0.797,10.2
303,203488,Mike Muscala,1610612755,PHI,13,8,5,310.0,15,6,6,0.4,37,0.405,0,0.405,7.0,43,11,19,0.256,76,0.566,7,0.623,6.0,58,17,25,0.293,110,0.527,7,0.563,6.3
304,203118,Mike Scott,1610612746,LAC,16,11,5,243.0,4,0,2,0.0,11,0.364,0,0.364,17.0,50,7,22,0.14,50,1.0,3,1.064,5.8,54,7,24,0.13,57,0.947,3,1.0,6.0
305,1628970,Miles Bridges,1610612766,CHA,15,7,8,312.0,9,8,1,0.889,23,0.391,1,0.409,5.7,53,19,29,0.358,73,0.726,6,0.791,6.9,62,27,30,0.435,92,0.674,7,0.729,6.7
306,203101,Miles Plumlee,1610612737,ATL,10,0,10,116.0,14,11,3,0.786,26,0.538,1,0.56,3.3,17,2,7,0.118,32,0.531,6,0.654,3.7,31,13,10,0.419,56,0.554,7,0.633,3.6
307,1628462,Milos Teodosic,1610612746,LAC,8,5,3,82.0,2,0,2,0.0,2,1.0,0,1.0,15.8,12,1,6,0.083,15,0.8,1,0.857,6.3,14,1,8,0.071,17,0.824,1,0.875,6.4
308,1629011,Mitchell Robinson,1610612752,NYK,15,4,11,273.0,32,18,11,0.563,53,0.604,0,0.604,6.6,30,5,12,0.167,45,0.667,5,0.75,9.1,62,23,23,0.371,96,0.646,5,0.681,7.8
309,1628964,Mo Bamba,1610612753,ORL,17,9,8,301.0,21,16,4,0.762,45,0.467,1,0.477,4.6,58,17,28,0.293,92,0.63,11,0.716,3.7,79,33,32,0.418,133,0.594,12,0.653,3.9
310,1628420,Monte Morris,1610612743,DEN,17,10,7,406.0,5,0,5,0.0,17,0.294,0,0.294,16.8,38,2,16,0.053,39,0.974,1,1.0,8.6,43,2,21,0.047,56,0.768,1,0.782,10.3
311,1626149,Montrezl Harrell,1610612746,LAC,16,11,5,389.0,32,15,10,0.469,85,0.376,0,0.376,4.9,78,27,29,0.346,132,0.591,11,0.645,5.3,110,42,39,0.382,209,0.526,11,0.556,5.2
312,1629021,Moritz Wagner,1610612747,LAL,1,0,1,2.0,0,0,0,0.0,0,0.0,0,0.0,0.0,0,0,0,0.0,0,0.0,0,0.0,0.0,0,0,0,0.0,0,0.0,0,0.0,0.0
313,1626167,Myles Turner,1610612754,IND,17,11,6,452.0,21,15,4,0.714,47,0.447,1,0.457,8.0,69,20,21,0.29,124,0.556,14,0.627,4.5,90,35,25,0.389,168,0.536,15,0.588,5.8
314,1628513,Naz Mitrou-Long,1610612762,UTA,1,0,1,4.0,0,0,0,0.0,0,0.0,0,0.0,0.0,0,0,0,0.0,0,0.0,1,0.0,0.0,0,0,0,0.0,0,0.0,1,0.0,0.0
315,202357,Nemanja Bjelica,1610612758,SAC,17,9,8,429.0,19,12,4,0.632,41,0.463,4,0.514,5.8,76,14,35,0.184,114,0.667,8,0.717,5.0,95,26,39,0.274,151,0.629,12,0.683,5.1
316,203457,Nerlens Noel,1610612760,OKC,15,10,5,208.0,34,23,6,0.676,55,0.618,1,0.63,5.6,46,13,23,0.283,72,0.639,7,0.708,4.8,80,36,29,0.45,123,0.65,8,0.696,5.2
317,201587,Nicolas Batum,1610612766,CHA,16,8,8,500.0,21,11,8,0.524,49,0.429,2,0.447,9.6,73,16,46,0.219,116,0.629,6,0.664,6.1,94,27,54,0.287,160,0.588,8,0.618,6.9
318,203917,Nik Stauskas,1610612757,POR,16,11,5,290.0,5,0,3,0.0,9,0.556,0,0.556,10.9,30,1,11,0.033,28,1.071,4,1.25,8.5,35,1,14,0.029,37,0.946,4,1.061,8.3
319,203999,Nikola Jokic,1610612743,DEN,17,10,7,506.0,42,24,9,0.571,90,0.467,1,0.472,4.7,128,23,45,0.18,165,0.776,6,0.805,4.1,170,47,54,0.276,244,0.697,7,0.717,4.4
320,202703,Nikola Mirotic,1610612740,NOP,15,8,7,468.0,31,18,12,0.581,61,0.508,1,0.517,7.1,133,18,66,0.135,139,0.957,7,1.008,4.6,164,36,78,0.22,187,0.877,8,0.916,5.2
321,202696,Nikola Vucevic,1610612753,ORL,17,9,8,518.0,47,35,11,0.745,83,0.566,2,0.58,7.2,137,34,70,0.248,189,0.725,7,0.753,4.2,184,69,81,0.375,261,0.705,9,0.73,5.0
322,203943,Noah Vonleh,1610612752,NYK,17,4,13,394.0,35,26,6,0.743,84,0.417,1,0.422,5.4,100,20,55,0.2,150,0.667,9,0.709,4.3,135,46,61,0.341,227,0.595,10,0.622,4.5
323,1626181,Norman Powell,1610612761,TOR,11,10,1,164.0,2,0,2,0.0,7,0.286,0,0.286,24.2,20,4,10,0.2,22,0.909,2,1.0,7.2,22,4,12,0.182,27,0.815,2,0.88,8.8
324,1628384,OG Anunoby,1610612761,TOR,13,10,3,297.0,10,5,2,0.5,22,0.455,0,0.455,6.5,24,7,10,0.292,30,0.8,0,0.8,5.9,34,12,12,0.353,50,0.68,0,0.68,5.5
325,1629016,Omari Spellman,1610612737,ATL,16,3,13,314.0,30,17,9,0.567,59,0.508,4,0.545,6.7,51,7,30,0.137,88,0.58,7,0.63,4.9,81,24,39,0.296,139,0.583,11,0.633,5.3
326,201956,Omri Casspi,1610612763,MEM,10,8,2,109.0,3,2,1,0.667,10,0.3,1,0.333,1.8,17,2,9,0.118,17,1.0,2,1.133,3.8,20,4,10,0.2,26,0.769,3,0.87,3.4
327,203490,Otto Porter Jr.,1610612764,WAS,15,4,11,420.0,10,3,6,0.3,33,0.303,2,0.323,7.1,56,9,31,0.161,87,0.644,6,0.691,6.7,66,12,37,0.182,117,0.564,8,0.606,6.8
328,200782,PJ Tucker,1610612745,HOU,15,8,7,532.0,18,11,8,0.611,51,0.353,0,0.353,9.7,66,12,24,0.182,111,0.595,6,0.629,5.9,84,23,32,0.274,155,0.542,6,0.564,6.7
329,1627783,Pascal Siakam,1610612761,TOR,17,13,4,489.0,26,6,15,0.231,48,0.542,1,0.553,10.0,88,19,49,0.216,119,0.739,5,0.772,5.5,114,25,64,0.219,164,0.695,6,0.722,6.4
330,1626192,Pat Connaughton,1610612749,MIL,13,9,4,223.0,15,8,6,0.533,22,0.682,0,0.682,7.7,44,4,34,0.091,55,0.8,4,0.863,5.8,59,12,40,0.203,77,0.766,4,0.808,6.3
331,201976,Patrick Beverley,1610612746,LAC,16,11,5,422.0,15,7,8,0.467,45,0.333,5,0.375,10.4,53,3,28,0.057,78,0.679,6,0.736,7.5,68,10,36,0.147,122,0.557,11,0.613,8.3
332,202335,Patrick Patterson,1610612760,OKC,16,10,6,270.0,15,8,4,0.533,28,0.536,1,0.556,7.8,33,8,16,0.242,56,0.589,6,0.66,4.1,48,16,20,0.333,83,0.578,7,0.632,5.3
333,201988,Patty Mills,1610612759,SAS,16,8,8,419.0,6,0,6,0.0,14,0.429,0,0.429,19.2,46,3,29,0.065,58,0.793,1,0.807,9.1,52,3,35,0.058,71,0.732,1,0.743,10.5
334,2200,Pau Gasol,1610612759,SAS,9,6,3,157.0,11,8,3,0.727,17,0.647,0,0.647,5.5,44,12,24,0.273,55,0.8,2,0.83,5.6,55,20,27,0.364,70,0.786,2,0.809,5.6
335,202331,Paul George,1610612760,OKC,16,10,6,568.0,18,7,7,0.389,42,0.429,2,0.45,11.8,108,24,58,0.222,148,0.73,11,0.788,7.1,126,31,65,0.246,181,0.696,13,0.75,7.8
336,200794,Paul Millsap,1610612743,DEN,17,10,7,449.0,37,21,9,0.568,84,0.44,4,0.463,5.2,79,11,39,0.139,116,0.681,6,0.718,4.9,116,32,48,0.276,199,0.583,10,0.614,5.1
337,202347,Quincy Pondexter,1610612759,SAS,13,5,8,87.0,4,1,3,0.25,9,0.444,1,0.5,10.0,12,0,6,0.0,12,1.0,3,1.333,6.5,16,1,9,0.063,21,0.762,4,0.941,7.9
338,1626188,Quinn Cook,1610612744,GSW,15,9,6,270.0,5,0,4,0.0,5,1.0,0,1.0,11.9,30,1,21,0.033,45,0.667,4,0.732,7.1,35,1,25,0.029,50,0.7,4,0.761,7.8
339,200765,Rajon Rondo,1610612747,LAL,11,6,5,278.0,10,4,6,0.4,29,0.345,3,0.385,14.3,40,5,30,0.125,69,0.58,5,0.625,8.1,50,9,36,0.18,96,0.521,8,0.568,9.2
340,203526,Raul Neto,1610612762,UTA,1,0,1,9.0,0,0,0,0.0,0,0.0,0,0.0,0.0,0,0,0,0.0,0,0.0,0,0.0,0.0,0,0,0,0.0,0,0.0,0,0.0,0.0
341,1629034,Ray Spalding,1610612742,DAL,1,0,1,1.0,0,0,0,0.0,0,0.0,0,0.0,0.0,0,0,0,0.0,0,0.0,0,0.0,0.0,0,0,0,0.0,0,0.0,0,0.0,0.0
342,101109,Raymond Felton,1610612760,OKC,10,6,4,125.0,2,0,2,0.0,8,0.25,1,0.286,12.6,13,2,6,0.154,11,1.182,1,1.3,10.1,15,2,8,0.133,19,0.789,2,0.882,10.6
343,203493,Reggie Bullock,1610612765,DET,11,7,4,307.0,5,3,2,0.6,14,0.357,1,0.385,14.2,20,4,10,0.2,33,0.606,3,0.667,9.9,25,7,12,0.28,45,0.556,4,0.61,11.0
344,202704,Reggie Jackson,1610612765,DET,14,8,6,407.0,11,2,8,0.182,23,0.478,2,0.524,14.6,25,1,14,0.04,40,0.625,2,0.658,9.4,36,3,22,0.083,63,0.571,4,0.61,11.7
345,1626158,Richaun Holmes,1610612756,PHX,15,2,13,165.0,22,10,8,0.455,36,0.611,0,0.611,6.1,34,10,11,0.294,45,0.756,3,0.81,4.7,56,20,19,0.357,79,0.709,3,0.737,5.2
346,201937,Ricky Rubio,1610612762,UTA,17,8,9,508.0,6,1,3,0.167,12,0.5,0,0.5,15.5,51,1,26,0.02,55,0.927,6,1.041,8.5,57,2,29,0.035,67,0.851,6,0.934,9.1
347,203496,Robert Covington,1610612750,MIN,16,10,6,542.0,8,4,4,0.5,25,0.32,2,0.348,13.7,73,12,33,0.164,96,0.76,12,0.869,6.1,81,16,37,0.198,117,0.692,14,0.786,7.0
348,1629057,Robert Williams III,1610612738,BOS,5,3,2,15.0,3,2,1,0.667,6,0.5,0,0.5,10.4,1,1,1,1.0,3,0.333,0,0.333,15.4,4,3,2,0.75,8,0.5,0,0.5,12.4
349,201577,Robin Lopez,1610612741,CHI,11,2,9,173.0,13,10,2,0.769,17,0.765,0,0.765,3.5,6,2,1,0.333,25,0.24,6,0.316,4.8,19,12,3,0.632,42,0.452,6,0.528,3.8
350,1629066,Rodions Kurucs,1610612751,BKN,7,3,4,82.0,7,5,1,0.714,15,0.467,2,0.538,4.5,14,3,9,0.214,18,0.778,3,0.933,5.4,21,8,10,0.381,32,0.656,5,0.778,5.1
351,203918,Rodney Hood,1610612739,CLE,15,2,13,402.0,5,2,3,0.4,13,0.385,0,0.385,13.4,33,4,19,0.121,38,0.868,3,0.943,8.7,38,6,22,0.158,50,0.76,3,0.809,9.3
352,203585,Rodney McGruder,1610612748,MIA,16,6,10,534.0,17,11,6,0.647,47,0.362,1,0.37,6.4,68,7,41,0.103,109,0.624,13,0.708,8.7,85,18,47,0.212,154,0.552,14,0.607,8.1
353,1627758,Ron Baker,1610612752,NYK,9,2,7,92.0,1,1,0,1.0,1,1.0,0,1.0,6.0,5,1,5,0.2,8,0.625,1,0.714,14.0,6,2,5,0.333,8,0.75,1,0.857,12.9
354,1626178,Rondae Hollis-Jefferson,1610612751,BKN,13,5,8,265.0,19,10,5,0.526,40,0.475,0,0.475,8.1,49,4,14,0.082,64,0.766,5,0.831,7.4,68,14,19,0.206,100,0.68,5,0.716,7.2
355,1626220,Royce O'Neale,1610612762,UTA,17,8,9,250.0,5,0,4,0.0,12,0.417,1,0.455,9.1,36,5,16,0.139,44,0.818,6,0.947,5.0,41,5,20,0.122,56,0.732,7,0.837,5.7
356,200752,Rudy Gay,1610612759,SAS,12,7,5,326.0,20,10,6,0.5,39,0.513,2,0.541,9.1,69,14,39,0.203,100,0.69,3,0.711,4.5,89,24,45,0.27,132,0.674,5,0.701,5.5
357,203497,Rudy Gobert,1610612762,UTA,17,8,9,549.0,60,34,16,0.567,126,0.476,4,0.492,4.8,157,26,65,0.166,191,0.822,14,0.887,3.4,217,60,81,0.276,302,0.719,18,0.764,3.8
358,201566,Russell Westbrook,1610612760,OKC,8,5,3,257.0,9,2,7,0.222,30,0.3,2,0.321,12.5,62,3,45,0.048,81,0.765,5,0.816,6.4,71,5,52,0.07,103,0.689,7,0.74,7.4
359,201583,Ryan Anderson,1610612756,PHX,12,3,9,244.0,12,8,4,0.667,32,0.375,1,0.387,6.7,28,8,16,0.286,49,0.571,4,0.622,4.2,40,16,20,0.4,79,0.506,5,0.541,5.1
360,1627853,Ryan Arcidiacono,1610612741,CHI,16,4,12,424.0,1,0,1,0.0,6,0.167,1,0.2,7.2,38,4,22,0.105,51,0.745,3,0.792,7.7,39,4,23,0.103,56,0.696,4,0.75,7.7
361,1629151,Ryan Broekhoff,1610612742,DAL,8,4,4,25.0,0,0,0,0.0,1,0.0,0,0.0,0.0,4,0,2,0.0,2,2.0,0,2.0,6.8,4,0,2,0.0,3,1.333,0,1.333,6.8
362,1626257,Salah Mejri,1610612742,DAL,3,2,1,12.0,1,1,0,1.0,1,1.0,0,1.0,9.7,3,0,2,0.0,3,1.0,1,1.5,6.2,4,1,2,0.25,4,1.0,1,1.333,7.3
363,1626155,Sam Dekker,1610612739,CLE,9,1,8,169.0,9,5,3,0.556,24,0.375,1,0.391,6.6,24,2,12,0.083,31,0.774,2,0.828,4.8,33,7,15,0.212,49,0.673,3,0.717,5.4
364,1628400,Semi Ojeleye,1610612738,BOS,11,7,4,99.0,4,2,2,0.5,7,0.571,1,0.667,11.0,9,4,4,0.444,14,0.643,3,0.818,7.8,13,6,6,0.462,21,0.619,4,0.765,8.8
365,201586,Serge Ibaka,1610612761,TOR,16,13,3,429.0,36,27,8,0.75,76,0.474,0,0.474,5.0,89,15,41,0.169,120,0.742,9,0.802,4.1,125,42,49,0.336,187,0.668,9,0.702,4.3
366,203552,Seth Curry,1610612757,POR,14,10,4,239.0,2,2,0,1.0,5,0.4,0,0.4,7.5,17,1,5,0.059,10,1.7,0,1.7,11.4,19,3,5,0.158,15,1.267,0,1.267,10.4
367,203894,Shabazz Napier,1610612751,BKN,13,5,8,198.0,3,0,3,0.0,8,0.375,1,0.429,26.8,14,0,10,0.0,24,0.583,4,0.7,5.9,17,0,13,0.0,32,0.531,5,0.63,10.0
368,1628983,Shai Gilgeous-Alexander,1610612746,LAC,16,11,5,438.0,13,4,7,0.308,27,0.481,3,0.542,15.5,39,11,19,0.282,60,0.65,4,0.696,6.5,52,15,26,0.288,86,0.605,7,0.658,8.6
369,1627885,Shaquille Harrison,1610612741,CHI,8,2,6,136.0,4,3,1,0.75,9,0.444,0,0.444,5.3,28,2,21,0.071,36,0.778,1,0.8,7.3,32,5,22,0.156,44,0.727,1,0.744,7.0
370,2733,Shaun Livingston,1610612744,GSW,9,5,4,144.0,10,6,4,0.6,17,0.588,1,0.625,6.7,14,2,7,0.143,22,0.636,4,0.778,9.6,24,8,11,0.333,39,0.615,5,0.706,7.7
371,202714,Shelvin Mack,1610612763,MEM,16,11,5,416.0,5,4,1,0.8,13,0.385,1,0.417,10.9,33,3,21,0.091,43,0.767,4,0.846,10.0,38,7,22,0.184,55,0.691,5,0.76,10.1
372,1628414,Sindarius Thornwell,1610612746,LAC,5,5,0,43.0,0,0,0,0.0,1,0.0,0,0.0,0.0,9,1,4,0.111,10,0.9,0,0.9,5.0,9,1,4,0.111,11,0.818,0,0.818,5.0
373,1627746,Skal Labissiere,1610612758,SAC,6,2,4,35.0,1,1,0,1.0,2,0.5,0,0.5,9.4,7,0,4,0.0,4,1.75,0,1.75,11.1,8,1,4,0.125,6,1.333,0,1.333,10.8
374,203524,Solomon Hill,1610612740,NOP,8,4,4,142.0,2,2,0,1.0,8,0.25,0,0.25,5.2,15,3,8,0.2,14,1.071,0,1.071,7.2,17,5,8,0.294,22,0.773,0,0.773,7.0
375,203915,Spencer Dinwiddie,1610612751,BKN,17,7,10,468.0,12,2,8,0.167,20,0.6,1,0.632,12.1,33,3,17,0.091,45,0.733,2,0.767,9.7,45,5,25,0.111,64,0.703,3,0.738,10.2
376,1626169,Stanley Johnson,1610612765,DET,13,7,6,313.0,11,7,3,0.636,29,0.379,1,0.393,10.2,47,7,19,0.149,65,0.723,1,0.734,7.2,58,14,22,0.241,90,0.644,2,0.659,8.1
377,201939,Stephen Curry,1610612744,GSW,12,10,2,399.0,6,5,1,0.833,20,0.3,2,0.333,10.4,54,6,28,0.111,75,0.72,3,0.75,7.5,60,11,29,0.183,95,0.632,5,0.667,7.7
378,1628425,Sterling Brown,1610612749,MIL,9,9,0,57.0,4,1,2,0.25,5,0.8,0,0.8,3.2,7,0,4,0.0,8,0.875,4,1.75,4.8,11,1,6,0.091,13,0.846,4,1.222,4.1
379,203500,Steven Adams,1610612760,OKC,15,9,6,507.0,73,44,23,0.603,167,0.437,3,0.445,6.4,83,21,41,0.253,143,0.58,12,0.634,4.8,156,65,64,0.417,309,0.505,15,0.531,5.9
380,1629004,Svi Mykhailiuk,1610612747,LAL,8,4,4,78.0,2,1,1,0.5,2,1.0,0,1.0,22.4,2,0,2,0.0,3,0.667,0,0.667,4.3,4,1,3,0.25,5,0.8,0,0.8,13.3
381,204456,T.J. McConnell,1610612755,PHI,13,7,6,184.0,1,0,0,0.0,6,0.167,2,0.25,0.0,21,0,14,0.0,29,0.724,4,0.84,8.0,22,0,14,0.0,35,0.629,6,0.759,8.0
382,203933,T.J. Warren,1610612756,PHX,15,2,13,447.0,12,5,5,0.417,29,0.414,2,0.444,8.8,51,12,21,0.235,66,0.773,5,0.836,6.4,63,17,26,0.27,89,0.708,7,0.768,7.0
383,1628388,TJ Leaf,1610612754,IND,10,8,2,66.0,4,0,3,0.0,6,0.667,0,0.667,11.8,8,2,3,0.25,11,0.727,1,0.8,6.0,12,2,6,0.167,17,0.706,1,0.75,8.1
384,201959,Taj Gibson,1610612750,MIN,17,7,10,459.0,52,33,15,0.635,104,0.5,3,0.515,6.5,63,7,39,0.111,115,0.548,9,0.594,5.9,115,40,54,0.348,213,0.54,12,0.572,6.1
385,1627752,Taurean Prince,1610612737,ATL,14,3,11,412.0,5,2,4,0.4,16,0.313,1,0.333,21.4,63,13,34,0.206,71,0.887,0,0.887,6.6,68,15,38,0.221,84,0.81,1,0.819,7.5
386,1628390,Terrance Ferguson,1610612760,OKC,14,9,5,313.0,11,4,7,0.364,16,0.688,0,0.688,12.0,19,5,9,0.263,30,0.633,3,0.704,7.7,30,9,16,0.3,46,0.652,3,0.698,9.3
387,203082,Terrence Ross,1610612753,ORL,17,9,8,423.0,4,1,3,0.25,12,0.333,0,0.333,13.4,48,10,27,0.208,70,0.686,4,0.727,7.4,52,11,30,0.212,79,0.658,4,0.693,7.8
388,1626179,Terry Rozier,1610612738,BOS,17,9,8,393.0,7,0,5,0.0,19,0.368,4,0.467,12.5,67,11,34,0.164,73,0.918,9,1.047,7.9,74,11,39,0.149,90,0.822,13,0.961,8.4
389,200757,Thabo Sefolosha,1610612762,UTA,5,0,5,44.0,2,1,0,0.5,1,2.0,0,2.0,5.9,13,1,8,0.077,11,1.182,0,1.182,7.6,15,2,8,0.133,12,1.25,0,1.25,7.5
390,201152,Thaddeus Young,1610612754,IND,17,11,6,478.0,30,17,9,0.567,79,0.38,0,0.38,5.1,62,8,30,0.129,100,0.62,5,0.653,5.7,92,25,39,0.272,174,0.529,5,0.544,5.7
391,1629033,Theo Pinson,1610612751,BKN,2,1,1,10.0,0,0,0,0.0,0,0.0,0,0.0,0.0,1,0,1,0.0,1,1.0,0,1.0,12.8,1,0,1,0.0,1,1.0,0,1.0,12.8
392,1628418,Thomas Bryant,1610612764,WAS,6,2,4,32.0,4,2,2,0.5,4,1.0,0,1.0,3.6,6,1,5,0.167,12,0.5,3,0.667,2.2,10,3,7,0.3,16,0.625,3,0.769,2.8
393,1629118,Thomas Welsh,1610612743,DEN,3,3,0,7.0,0,0,0,0.0,1,0.0,0,0.0,0.0,2,0,1,0.0,2,1.0,1,2.0,6.4,2,0,1,0.0,2,1.0,1,2.0,6.4
394,1627748,Thon Maker,1610612749,MIL,8,7,1,89.0,3,2,1,0.667,10,0.3,0,0.3,4.6,19,5,11,0.263,25,0.76,2,0.826,4.3,22,7,12,0.318,31,0.71,2,0.759,4.3
395,204025,Tim Frazier,1610612740,NOP,11,4,7,137.0,4,1,2,0.25,7,0.571,0,0.571,12.4,11,2,6,0.182,15,0.733,2,0.846,7.1,15,3,8,0.2,21,0.714,2,0.789,8.5
396,203501,Tim Hardaway Jr.,1610612752,NYK,16,4,12,518.0,7,4,1,0.571,29,0.241,3,0.269,9.4,51,5,35,0.098,70,0.729,5,0.785,7.5,58,9,36,0.155,94,0.617,8,0.674,7.7
397,1627789,Timothe Luwawu-Cabarrot,1610612760,OKC,9,7,2,60.0,3,1,1,0.333,6,0.5,1,0.6,12.4,7,0,1,0.0,6,1.167,0,1.167,3.2,10,1,2,0.1,11,0.909,1,1.0,5.7
398,202699,Tobias Harris,1610612746,LAC,16,11,5,558.0,15,6,7,0.4,33,0.455,1,0.469,6.4,124,26,55,0.21,164,0.756,11,0.81,5.2,139,32,62,0.23,192,0.724,12,0.772,5.3
399,203107,Tomas Satoransky,1610612764,WAS,16,5,11,199.0,5,3,2,0.6,15,0.333,1,0.357,6.1,19,2,11,0.105,24,0.792,1,0.826,6.8,24,5,13,0.208,39,0.615,2,0.649,7.1
400,2225,Tony Parker,1610612766,CHA,15,8,7,277.0,3,1,2,0.333,11,0.273,2,0.333,10.6,24,2,18,0.083,32,0.75,0,0.75,9.8,27,3,20,0.111,43,0.628,2,0.659,9.9
401,203503,Tony Snell,1610612749,MIL,16,12,4,264.0,4,2,2,0.5,11,0.364,0,0.364,10.6,24,1,19,0.042,40,0.6,2,0.632,7.9,28,3,21,0.107,46,0.609,2,0.636,8.1
402,1628470,Torrey Craig,1610612743,DEN,13,9,4,205.0,15,9,6,0.6,32,0.469,1,0.484,8.4,22,3,14,0.136,29,0.759,3,0.846,7.5,37,12,20,0.324,59,0.627,4,0.673,7.9
403,1629027,Trae Young,1610612737,ATL,17,3,14,513.0,9,3,5,0.333,32,0.281,1,0.29,13.3,45,3,29,0.067,51,0.882,2,0.918,10.5,54,6,34,0.111,81,0.667,3,0.692,11.4
404,1626203,Treveon Graham,1610612751,BKN,2,1,1,27.0,1,1,0,1.0,2,0.5,0,0.5,6.2,3,2,1,0.667,3,1.0,0,1.0,6.1,4,3,1,0.75,5,0.8,0,0.8,6.1
405,2772,Trevor Ariza,1610612756,PHX,14,2,12,477.0,7,1,3,0.143,18,0.389,1,0.412,12.0,72,14,44,0.194,93,0.774,6,0.828,5.8,79,15,47,0.19,106,0.745,7,0.798,6.3
406,203504,Trey Burke,1610612752,NYK,14,3,11,296.0,10,1,6,0.1,13,0.769,1,0.833,14.5,18,0,11,0.0,22,0.818,2,0.9,7.5,28,1,17,0.036,35,0.8,3,0.875,10.2
407,1626168,Trey Lyles,1610612743,DEN,17,10,7,356.0,12,6,4,0.5,27,0.444,2,0.48,4.7,71,14,34,0.197,79,0.899,1,0.91,4.7,83,20,38,0.241,102,0.814,3,0.838,4.6
408,202684,Tristan Thompson,1610612739,CLE,15,2,13,419.0,67,47,18,0.701,136,0.493,1,0.496,4.6,91,23,33,0.253,155,0.587,11,0.632,4.6,158,70,51,0.443,289,0.547,12,0.57,4.6
409,1628972,Troy Brown Jr.,1610612764,WAS,8,2,6,42.0,2,2,0,1.0,5,0.4,0,0.4,7.4,8,4,2,0.5,8,1.0,1,1.143,3.9,10,6,2,0.6,12,0.833,1,0.909,4.9
410,203584,Troy Daniels,1610612756,PHX,5,1,4,40.0,1,0,1,0.0,1,1.0,0,1.0,15.1,3,0,3,0.0,5,0.6,0,0.6,10.9,4,0,4,0.0,6,0.667,0,0.667,11.9
411,1627786,Troy Williams,1610612758,SAC,8,3,5,137.0,3,2,1,0.667,15,0.2,0,0.2,4.1,22,3,7,0.136,25,0.88,0,0.88,6.0,25,5,8,0.2,40,0.625,0,0.625,5.6
412,1628416,Tyler Dorsey,1610612737,ATL,9,0,9,102.0,1,0,1,0.0,4,0.25,0,0.25,7.2,14,1,8,0.071,20,0.7,2,0.778,5.6,15,1,9,0.067,23,0.652,2,0.714,5.6
413,204020,Tyler Johnson,1610612748,MIA,16,6,10,435.0,10,3,4,0.3,28,0.357,3,0.4,13.9,42,1,23,0.024,56,0.75,4,0.808,8.6,52,4,27,0.077,84,0.619,7,0.675,10.1
414,1628399,Tyler Lydon,1610612743,DEN,5,5,0,17.0,1,0,0,0.0,0,0.0,0,0.0,0.0,1,0,0,0.0,0,0.0,0,0.0,0.0,2,0,0,0.0,0,0.0,0,0.0,0.0
415,1627755,Tyler Ulis,1610612741,CHI,1,0,1,1.0,0,0,0,0.0,0,0.0,0,0.0,0.0,0,0,0,0.0,0,0.0,0,0.0,0.0,0,0,0,0.0,0,0.0,0,0.0,0.0
416,201936,Tyreke Evans,1610612754,IND,16,10,6,332.0,7,5,1,0.714,17,0.412,1,0.438,9.1,37,7,14,0.189,34,1.088,3,1.194,9.2,44,12,15,0.273,50,0.88,4,0.957,8.7
417,1627820,Tyrone Wallace,1610612746,LAC,11,8,3,77.0,1,1,0,1.0,7,0.143,1,0.167,6.6,8,1,3,0.125,7,1.143,2,1.6,6.9,9,2,3,0.222,14,0.643,3,0.818,6.8
418,2199,Tyson Chandler,1610612747,LAL,13,6,7,219.0,28,16,11,0.571,56,0.5,3,0.528,3.6,56,15,28,0.268,85,0.659,5,0.7,5.7,84,31,39,0.369,136,0.618,8,0.656,5.0
419,1626145,Tyus Jones,1610612750,MIN,16,6,10,297.0,5,0,4,0.0,9,0.556,0,0.556,17.8,21,0,11,0.0,24,0.875,0,0.875,9.5,26,0,15,0.0,33,0.788,0,0.788,10.8
420,2617,Udonis Haslem,1610612748,MIA,2,2,0,6.0,0,0,0,0.0,0,0.0,0,0.0,0.0,1,0,1,0.0,1,1.0,0,1.0,4.3,1,0,1,0.0,1,1.0,0,1.0,4.3
421,203506,Victor Oladipo,1610612754,IND,16,10,6,518.0,8,2,7,0.25,34,0.235,1,0.242,11.5,98,8,41,0.082,108,0.907,1,0.916,6.4,106,10,48,0.094,142,0.746,2,0.757,6.8
422,1713,Vince Carter,1610612737,ATL,17,3,14,309.0,5,4,1,0.8,13,0.385,0,0.385,11.3,35,7,18,0.2,71,0.493,5,0.53,5.8,40,11,19,0.275,83,0.482,5,0.513,6.2
423,1629053,Vincent Edwards,1610612745,HOU,1,1,0,4.0,1,0,1,0.0,1,1.0,0,1.0,20.7,0,0,0,0.0,0,0.0,0,0.0,0.0,1,0,1,0.0,1,1.0,0,1.0,20.7
424,1627735,Wade Baldwin IV,1610612757,POR,5,4,1,23.0,1,1,0,1.0,1,1.0,0,1.0,7.3,3,1,1,0.333,2,1.5,0,1.5,4.4,4,2,1,0.5,3,1.333,0,1.333,5.4
425,201961,Wayne Ellington,1610612748,MIA,9,3,6,210.0,2,0,2,0.0,9,0.222,2,0.286,9.7,17,3,11,0.176,28,0.607,2,0.654,12.9,19,3,13,0.158,36,0.528,4,0.594,12.5
426,1627782,Wayne Selden,1610612763,MEM,16,11,5,265.0,6,1,4,0.167,11,0.545,0,0.545,16.7,12,2,5,0.167,16,0.75,0,0.75,9.7,18,3,9,0.167,27,0.667,0,0.667,12.3
427,1628976,Wendell Carter Jr.,1610612741,CHI,17,4,13,440.0,38,22,11,0.579,74,0.514,1,0.521,7.0,88,22,38,0.25,146,0.603,7,0.633,4.0,126,44,49,0.349,218,0.578,8,0.6,4.9
428,1628411,Wes Iwundu,1610612753,ORL,13,7,6,236.0,8,4,3,0.5,14,0.571,2,0.667,7.2,22,2,12,0.091,22,1.0,2,1.1,5.7,30,6,15,0.2,36,0.833,4,0.938,6.2
429,202325,Wesley Johnson,1610612740,NOP,11,7,4,221.0,5,2,3,0.4,12,0.417,0,0.417,7.2,25,3,11,0.12,28,0.893,4,1.042,5.4,30,5,14,0.167,39,0.769,4,0.857,6.0
430,202083,Wesley Matthews,1610612742,DAL,13,5,8,422.0,7,3,4,0.429,14,0.5,0,0.5,12.2,27,3,17,0.111,36,0.75,6,0.9,8.6,34,6,21,0.176,49,0.694,6,0.791,9.5
431,203115,Will Barton,1610612743,DEN,2,2,0,54.0,0,0,0,0.0,2,0.0,0,0.0,0.0,10,2,8,0.2,13,0.769,1,0.833,5.2,10,2,8,0.2,14,0.714,1,0.769,5.2
432,1626161,Willie Cauley-Stein,1610612758,SAC,17,9,8,490.0,42,23,13,0.548,81,0.519,4,0.545,7.4,105,18,33,0.171,149,0.705,7,0.739,4.4,147,41,46,0.279,225,0.653,11,0.687,5.2
433,1626195,Willy Hernangomez,1610612766,CHA,15,8,7,213.0,30,20,9,0.667,58,0.517,1,0.526,6.7,44,12,22,0.273,71,0.62,1,0.629,4.9,74,32,31,0.432,128,0.578,2,0.587,5.6
434,201163,Wilson Chandler,1610612755,PHI,8,7,1,154.0,11,4,3,0.364,11,1.0,1,1.1,11.3,22,5,9,0.227,22,1.0,0,1.0,7.7,33,9,12,0.273,31,1.065,1,1.1,8.7
435,1627812,Yogi Ferrell,1610612758,SAC,11,6,5,173.0,2,0,2,0.0,7,0.286,1,0.333,18.5,18,1,11,0.056,28,0.643,1,0.667,8.4,20,1,13,0.05,34,0.588,2,0.625,9.5
436,1629139,Yuta Watanabe,1610612763,MEM,2,2,0,12.0,0,0,0,0.0,1,0.0,0,0.0,0.0,4,1,2,0.25,6,0.667,0,0.667,4.8,4,1,2,0.25,7,0.571,0,0.571,4.8
437,1628380,Zach Collins,1610612757,POR,16,11,5,330.0,20,11,6,0.55,38,0.526,0,0.526,4.8,50,13,17,0.26,67,0.746,7,0.833,4.8,70,24,23,0.343,103,0.68,7,0.729,4.9
438,203897,Zach LaVine,1610612741,CHI,16,4,12,575.0,6,4,1,0.667,47,0.128,1,0.13,7.6,81,11,47,0.136,97,0.835,9,0.92,5.9,87,15,48,0.172,140,0.621,10,0.669,6.1
439,1629155,Zach Lofton,1610612765,DET,1,1,0,4.0,0,0,0,0.0,0,0.0,0,0.0,0.0,0,0,0,0.0,0,0.0,0,0.0,0.0,0,0,0,0.0,0,0.0,0,0.0,0.0
440,2585,Zaza Pachulia,1610612765,DET,14,8,6,181.0,24,18,6,0.75,60,0.4,0,0.4,4.7,31,8,17,0.258,64,0.484,2,0.5,5.3,55,26,23,0.473,118,0.466,2,0.474,5.0
441,1627753,Zhou Qi,1610612745,HOU,1,0,1,1.0,0,0,0,0.0,0,0.0,0,0.0,0.0,0,0,0,0.0,0,0.0,0,0.0,0.0,0,0,0,0.0,0,0.0,0,0.0,0.0
