,PLAYER_ID,PLAYER_NAME,TEAM_ID,TEAM_ABBREVIATION,GP,W,L,MIN,OREB,OREB_CONTEST,OREB_UNCONTEST,OREB_CONTEST_PCT,OREB_CHANCES,OREB_CHANCE_PCT,OREB_CHANCE_DEFER,OREB_CHANCE_PCT_ADJ,AVG_OREB_DIST,DREB,DREB_CONTEST,DREB_UNCONTEST,DREB_CONTEST_PCT,DREB_CHANCES,DREB_CHANCE_PCT,DREB_CHANCE_DEFER,DREB_CHANCE_PCT_ADJ,AVG_DREB_DIST,REB,REB_CONTEST,REB_UNCONTEST,REB_CONTEST_PCT,REB_CHANCES,REB_CHANCE_PCT,REB_CHANCE_DEFER,REB_CHANCE_PCT_ADJ,AVG_REB_DIST
0,201985,AJ Price,1610612739,CLE,26,11,15,324.0,6,1,5,0.167,20,0.3,0,0.3,15.1,26,8,18,0.308,48,0.542,4,0.591,11.7,32,9,23,0.281,68,0.471,4,0.5,12.3
1,201166,Aaron Brooks,1610612741,CHI,82,50,32,1885.0,32,12,18,0.375,153,0.209,8,0.221,11.9,134,20,115,0.149,296,0.453,23,0.491,10.3,166,32,133,0.193,449,0.37,31,0.397,10.6
2,203932,Aaron Gordon,1610612753,ORL,47,14,33,797.0,46,34,11,0.739,110,0.418,3,0.43,5.5,123,38,86,0.309,208,0.591,18,0.647,5.8,169,72,97,0.426,318,0.531,21,0.569,5.7
3,203940,Adreian Payne,1610612750,MIN,32,7,25,740.0,48,26,25,0.542,117,0.41,5,0.429,8.0,114,37,75,0.325,188,0.606,16,0.663,4.5,162,63,100,0.389,305,0.531,21,0.57,5.6
4,201143,Al Horford,1610612737,ATL,76,56,20,2318.0,131,80,50,0.611,265,0.494,10,0.514,7.3,413,189,222,0.458,707,0.584,54,0.632,5.7,544,269,272,0.494,972,0.56,64,0.599,6.1
5,2744,Al Jefferson,1610612766,CHA,65,25,40,1992.0,99,59,39,0.596,237,0.418,9,0.434,8.6,449,163,282,0.363,701,0.641,51,0.691,4.1,548,222,321,0.405,938,0.584,60,0.624,4.9
6,202329,Al-Farouq Aminu,1610612742,DAL,74,45,29,1366.0,114,74,38,0.649,248,0.46,18,0.496,6.7,228,83,141,0.364,389,0.586,47,0.667,5.6,342,157,179,0.459,637,0.537,65,0.598,6.0
7,101187,Alan Anderson,1610612751,BKN,74,35,39,1744.0,31,15,15,0.484,124,0.25,7,0.265,10.4,173,40,129,0.231,311,0.556,35,0.627,8.2,204,55,144,0.27,435,0.469,42,0.519,8.6
8,202692,Alec Burks,1610612762,UTA,27,9,18,899.0,19,10,9,0.526,83,0.229,4,0.241,9.4,95,19,75,0.2,163,0.583,17,0.651,6.8,114,29,84,0.254,246,0.463,21,0.507,7.2
9,203945,Alex Kirk,1610612739,CLE,5,2,3,14.0,1,1,0,1.0,2,0.5,0,0.5,4.1,0,0,0,0.0,0,0.0,0,0.0,0.0,1,1,0,1.0,2,0.5,0,0.5,4.1
10,203458,Alex Len,1610612756,PHX,69,35,34,1518.0,142,105,34,0.739,335,0.424,8,0.434,5.1,312,159,152,0.51,593,0.526,71,0.598,3.6,454,264,186,0.581,928,0.489,79,0.535,4.1
11,203144,Alexey Shved,1610612752,NYK,42,10,32,767.0,23,12,12,0.522,86,0.267,4,0.28,11.6,76,17,59,0.224,136,0.559,12,0.613,8.4,99,29,71,0.293,222,0.446,16,0.481,9.3
12,201582,Alexis Ajinca,1610612740,NOP,68,41,27,957.0,104,72,32,0.692,222,0.468,5,0.479,5.5,211,91,123,0.431,333,0.634,21,0.676,4.1,315,163,155,0.517,555,0.568,26,0.595,4.6
13,203459,Allen Crabbe,1610612757,POR,51,36,15,683.0,7,2,4,0.286,35,0.2,0,0.2,14.3,66,12,54,0.182,126,0.524,9,0.564,5.9,73,14,58,0.192,161,0.453,9,0.48,6.6
14,202087,Alonzo Gee,1610612757,POR,54,21,33,661.0,37,20,16,0.541,120,0.308,7,0.327,8.0,57,21,36,0.368,106,0.538,8,0.582,7.5,94,41,52,0.436,226,0.416,15,0.445,7.7
15,2405,Amar'e Stoudemire,1610612742,DAL,58,19,39,1236.0,109,84,23,0.771,283,0.385,8,0.396,5.0,218,103,115,0.472,400,0.545,33,0.594,3.9,327,187,138,0.572,683,0.479,41,0.509,4.2
16,101161,Amir Johnson,1610612761,TOR,75,44,31,1979.0,159,118,40,0.742,382,0.416,12,0.43,5.4,297,153,141,0.515,635,0.468,72,0.528,4.3,456,271,181,0.594,1017,0.448,84,0.489,4.7
17,2760,Anderson Varejao,1610612739,CLE,26,16,10,636.0,57,30,24,0.526,143,0.399,3,0.407,6.1,113,45,68,0.398,220,0.514,19,0.562,4.7,170,75,92,0.441,363,0.468,22,0.499,5.2
18,203958,Andre Dawkins,1610612748,MIA,4,2,2,22.0,0,0,0,0.0,0,0.0,0,0.0,0.0,2,2,0,1.0,4,0.5,1,0.667,9.6,2,2,0,1.0,4,0.5,1,0.667,9.6
19,203083,Andre Drummond,1610612765,DET,82,32,50,2502.0,437,321,103,0.735,785,0.557,12,0.565,4.8,667,273,393,0.409,995,0.67,66,0.718,3.9,1104,594,496,0.538,1780,0.62,78,0.649,4.3
20,2738,Andre Iguodala,1610612744,GSW,77,64,13,2069.0,44,14,30,0.318,149,0.295,3,0.301,13.0,213,47,175,0.221,363,0.587,16,0.614,9.1,257,61,205,0.237,512,0.502,19,0.521,9.8
21,1889,Andre Miller,1610612758,SAC,81,44,37,1253.0,37,24,12,0.649,141,0.262,9,0.28,8.2,116,17,99,0.147,198,0.586,13,0.627,10.8,153,41,111,0.268,339,0.451,22,0.483,10.2
22,203460,Andre Roberson,1610612760,OKC,67,41,26,1286.0,60,30,27,0.5,206,0.291,4,0.297,8.2,195,59,136,0.303,325,0.6,28,0.657,5.9,255,89,163,0.349,531,0.48,32,0.511,6.4
23,200745,Andrea Bargnani,1610612752,NYK,29,5,24,785.0,32,17,15,0.531,88,0.364,5,0.386,8.0,95,27,66,0.284,170,0.559,12,0.601,5.5,127,44,81,0.346,258,0.492,17,0.527,6.1
24,1905,Andrei Kirilenko,1610612751,BKN,7,3,4,36.0,2,1,1,0.5,6,0.333,0,0.333,15.2,6,3,3,0.5,11,0.545,3,0.75,3.1,8,4,4,0.5,17,0.471,3,0.571,6.1
25,101106,Andrew Bogut,1610612744,GSW,67,58,9,1583.0,141,105,34,0.745,270,0.522,3,0.528,5.0,402,193,202,0.48,705,0.57,58,0.621,3.9,543,298,236,0.549,975,0.557,61,0.594,4.2
26,203094,Andrew Nicholson,1610612753,ORL,40,14,26,492.0,17,10,6,0.588,45,0.378,0,0.378,7.3,65,32,33,0.492,135,0.481,16,0.546,4.3,82,42,39,0.512,180,0.456,16,0.5,4.9
27,203952,Andrew Wiggins,1610612750,MIN,81,16,65,2937.0,134,91,40,0.679,430,0.312,13,0.321,6.4,239,81,158,0.339,454,0.526,30,0.564,8.1,373,172,198,0.461,884,0.422,43,0.444,7.5
28,203461,Anthony Bennett,1610612750,MIN,56,12,44,885.0,51,33,17,0.647,127,0.402,4,0.415,6.4,161,57,103,0.354,257,0.626,16,0.668,4.6,212,90,120,0.425,384,0.552,20,0.582,5.0
29,203076,Anthony Davis,1610612740,NOP,68,39,29,2455.0,173,120,51,0.694,360,0.481,12,0.497,5.8,523,222,298,0.424,730,0.716,35,0.753,4.8,696,342,349,0.491,1090,0.639,47,0.667,5.1
30,201627,Anthony Morrow,1610612760,OKC,74,42,32,1806.0,40,17,23,0.425,108,0.37,2,0.377,12.8,155,46,107,0.297,236,0.657,20,0.718,9.0,195,63,130,0.323,344,0.567,22,0.606,9.8
31,201229,Anthony Tolliver,1610612765,DET,76,36,40,1433.0,51,18,30,0.353,134,0.381,4,0.392,8.5,185,59,128,0.319,402,0.46,42,0.514,5.0,236,77,158,0.326,536,0.44,46,0.482,5.7
32,203462,Archie Goodwin,1610612756,PHX,41,16,25,535.0,27,19,6,0.704,90,0.3,3,0.31,6.6,47,13,36,0.277,91,0.516,7,0.56,6.5,74,32,42,0.432,181,0.409,10,0.433,6.6
33,202620,Arinze Onuaku,1610612750,MIN,6,0,6,68.0,7,6,1,0.857,15,0.467,0,0.467,3.5,14,5,9,0.357,18,0.778,0,0.778,4.9,21,11,10,0.524,33,0.636,0,0.636,4.4
34,203382,Aron Baynes,1610612759,SAS,70,49,21,1122.0,109,77,29,0.706,309,0.353,7,0.361,4.9,209,95,113,0.455,372,0.562,40,0.63,4.4,318,172,142,0.541,681,0.467,47,0.502,4.6
35,201167,Arron Afflalo,1610612757,POR,78,35,43,2502.0,27,12,16,0.444,117,0.231,4,0.239,16.2,220,20,200,0.091,359,0.613,26,0.661,9.6,247,32,216,0.13,476,0.519,30,0.554,10.4
36,201948,Austin Daye,1610612737,ATL,34,17,17,344.0,10,4,6,0.4,24,0.417,0,0.417,14.9,65,25,39,0.385,104,0.625,10,0.691,6.2,75,29,45,0.387,128,0.586,10,0.636,7.4
37,203085,Austin Rivers,1610612746,LAC,76,46,30,1563.0,27,11,16,0.407,124,0.218,6,0.229,11.6,125,21,106,0.168,276,0.453,32,0.512,8.5,152,32,122,0.211,400,0.38,38,0.42,9.0
38,202340,Avery Bradley,1610612738,BOS,77,37,40,2428.0,46,13,37,0.283,188,0.245,9,0.257,14.0,195,27,172,0.138,386,0.505,42,0.567,6.1,241,40,209,0.166,574,0.42,51,0.461,7.8
39,2732,Ben Gordon,1610612753,ORL,56,17,39,790.0,6,1,6,0.167,39,0.154,1,0.158,14.0,57,11,47,0.193,107,0.533,13,0.606,9.1,63,12,53,0.19,146,0.432,14,0.477,9.7
40,203463,Ben McLemore,1610612758,SAC,82,29,53,2670.0,31,5,24,0.161,156,0.199,7,0.208,15.1,210,36,174,0.171,450,0.467,45,0.519,7.9,241,41,198,0.17,606,0.398,52,0.435,8.7
41,2757,Beno Udrih,1610612763,MEM,79,55,24,1494.0,20,7,13,0.35,78,0.256,3,0.267,15.2,123,15,110,0.122,255,0.482,25,0.535,10.2,143,22,123,0.154,333,0.429,28,0.469,10.9
42,203108,Bernard James,1610612742,DAL,16,6,10,158.0,18,12,6,0.667,43,0.419,2,0.439,5.4,21,9,12,0.429,42,0.5,4,0.553,5.6,39,21,18,0.538,85,0.459,6,0.494,5.5
43,202687,Bismack Biyombo,1610612766,CHA,64,26,38,1243.0,159,126,32,0.792,388,0.41,16,0.427,5.0,248,92,153,0.371,459,0.54,41,0.593,4.5,407,218,185,0.536,847,0.481,57,0.515,4.7
44,201933,Blake Griffin,1610612746,LAC,67,47,20,2356.0,126,83,36,0.659,315,0.4,20,0.427,7.2,382,143,237,0.374,680,0.562,47,0.603,5.0,508,226,273,0.445,995,0.511,67,0.547,5.5
45,202711,Bojan Bogdanovic,1610612751,BKN,78,36,42,1854.0,50,36,14,0.72,181,0.276,5,0.284,7.5,163,26,137,0.16,266,0.613,14,0.647,8.5,213,62,151,0.291,447,0.477,19,0.498,8.2
46,2564,Boris Diaw,1610612759,SAS,81,55,26,1984.0,78,50,26,0.641,226,0.345,14,0.368,7.2,270,91,177,0.337,514,0.525,49,0.581,5.8,348,141,203,0.405,740,0.47,63,0.514,6.1
47,203078,Bradley Beal,1610612764,WAS,63,37,26,2107.0,57,28,28,0.491,191,0.298,8,0.311,10.8,184,40,141,0.217,307,0.599,25,0.652,6.7,241,68,169,0.282,498,0.484,33,0.518,7.7
48,201148,Brandan Wright,1610612756,PHX,75,37,38,1449.0,128,67,58,0.523,248,0.516,8,0.533,7.6,193,91,99,0.472,402,0.48,42,0.536,5.2,321,158,157,0.492,650,0.494,50,0.535,6.2
49,101138,Brandon Bass,1610612738,BOS,82,40,42,1929.0,139,81,56,0.583,309,0.45,14,0.471,7.1,259,82,175,0.317,448,0.578,39,0.633,6.5,398,163,231,0.41,757,0.526,53,0.565,6.7
50,203561,Brandon Davies,1610612755,PHI,27,6,21,423.0,38,21,12,0.553,77,0.494,1,0.5,7.0,45,15,30,0.333,100,0.45,10,0.5,5.3,83,36,42,0.434,177,0.469,11,0.5,6.0
51,201943,Brandon Jennings,1610612765,DET,41,17,24,1173.0,21,8,15,0.381,96,0.219,4,0.228,13.3,83,10,73,0.12,164,0.506,14,0.553,10.1,104,18,88,0.173,260,0.4,18,0.43,11.0
52,202688,Brandon Knight,1610612756,PHX,62,32,30,2000.0,27,14,12,0.519,129,0.209,8,0.223,12.3,212,30,182,0.142,406,0.522,32,0.567,8.1,239,44,194,0.184,535,0.447,40,0.483,8.6
53,201575,Brandon Rush,1610612744,GSW,33,27,6,271.0,4,2,2,0.5,14,0.286,0,0.286,12.2,37,10,27,0.27,65,0.569,6,0.627,5.4,41,12,29,0.293,79,0.519,6,0.562,6.1
54,2217,Brendan Haywood,1610612739,CLE,22,14,8,119.0,6,3,3,0.5,20,0.3,0,0.3,6.5,23,6,16,0.261,39,0.59,7,0.719,4.8,29,9,19,0.31,59,0.492,7,0.558,5.2
55,203148,Brian Roberts,1610612766,CHA,72,30,42,1330.0,13,2,11,0.154,56,0.232,6,0.26,18.9,96,3,96,0.031,197,0.487,20,0.542,10.1,109,5,107,0.046,253,0.431,26,0.48,11.1
56,201572,Brook Lopez,1610612751,BKN,72,34,38,2100.0,214,157,43,0.734,396,0.54,5,0.547,5.5,321,154,162,0.48,576,0.557,50,0.61,5.4,535,311,205,0.581,972,0.55,55,0.583,5.4
57,203998,Bruno Caboclo,1610612761,TOR,8,7,1,23.0,1,1,0,1.0,4,0.25,1,0.333,2.3,1,0,1,0.0,2,0.5,0,0.5,22.0,2,1,1,0.5,6,0.333,1,0.4,12.1
58,203955,Bryce Cotton,1610612762,UTA,15,9,6,159.0,3,1,2,0.333,6,0.5,0,0.5,22.1,15,1,14,0.067,24,0.625,0,0.625,9.6,18,2,16,0.111,30,0.6,0,0.6,11.7
59,201228,C.J. Watson,1610612754,IND,57,25,32,1422.0,18,3,16,0.167,75,0.24,3,0.25,14.7,145,17,127,0.117,276,0.525,22,0.571,8.5,163,20,143,0.123,351,0.464,25,0.5,9.2
60,203468,CJ McCollum,1610612757,POR,62,37,25,973.0,14,5,9,0.357,58,0.241,4,0.259,10.6,77,14,63,0.182,159,0.484,13,0.527,8.7,91,19,72,0.209,217,0.419,17,0.455,9.0
61,101139,CJ Miles,1610612754,IND,70,31,39,1841.0,18,3,12,0.167,101,0.178,1,0.18,15.2,196,44,150,0.224,337,0.582,30,0.638,7.5,214,47,162,0.22,438,0.489,31,0.526,8.1
62,203912,CJ Wilcox,1610612746,LAC,21,15,6,101.0,1,1,0,1.0,4,0.25,0,0.25,16.8,6,1,5,0.167,15,0.4,0,0.4,6.0,7,2,5,0.286,19,0.368,0,0.368,7.6
63,203946,Cameron Bairstow,1610612741,CHI,18,12,6,64.0,6,6,0,1.0,18,0.333,0,0.333,5.8,2,0,2,0.0,17,0.118,1,0.125,3.3,8,6,2,0.75,35,0.229,1,0.235,5.1
64,201171,Carl Landry,1610612758,SAC,70,26,44,1192.0,99,65,32,0.657,246,0.402,8,0.416,6.4,169,56,112,0.331,292,0.579,29,0.643,6.1,268,121,144,0.451,538,0.498,37,0.535,6.3
65,2430,Carlos Boozer,1610612747,LAL,71,18,53,1692.0,111,76,34,0.685,311,0.357,10,0.369,6.1,371,137,227,0.369,572,0.649,39,0.696,4.7,482,213,261,0.442,883,0.546,49,0.578,5.0
66,2546,Carmelo Anthony,1610612752,NYK,39,10,29,1400.0,72,49,22,0.681,161,0.447,5,0.462,7.1,189,49,140,0.259,293,0.645,21,0.695,5.9,261,98,162,0.375,454,0.575,26,0.61,6.2
67,2406,Caron Butler,1610612765,DET,78,30,48,1623.0,21,11,10,0.524,127,0.165,2,0.168,10.6,175,46,126,0.263,345,0.507,36,0.566,6.4,196,57,136,0.291,472,0.415,38,0.452,6.9
68,201858,Cartier Martin,1610612765,DET,23,7,16,198.0,0,0,0,0.0,12,0.0,0,0.0,0.0,20,6,12,0.3,32,0.625,5,0.741,6.2,20,6,12,0.3,44,0.455,5,0.513,6.2
69,202718,Chandler Parsons,1610612742,DAL,66,41,25,2186.0,64,35,28,0.547,235,0.272,12,0.287,9.9,259,65,195,0.251,459,0.564,27,0.6,7.3,323,100,223,0.31,694,0.465,39,0.493,7.8
70,101112,Channing Frye,1610612753,ORL,75,23,52,1870.0,27,15,10,0.556,58,0.466,1,0.474,9.9,266,110,156,0.414,467,0.57,35,0.616,4.6,293,125,166,0.427,525,0.558,36,0.599,5.0
71,101111,Charlie Villanueva,1610612742,DAL,64,37,27,678.0,30,16,11,0.533,69,0.435,2,0.448,7.2,119,40,79,0.336,188,0.633,10,0.669,4.7,149,56,90,0.376,257,0.58,12,0.608,5.2
72,201978,Chase Budinger,1610612750,MIN,66,8,58,1282.0,33,18,16,0.545,108,0.306,3,0.314,8.9,164,42,122,0.256,276,0.594,19,0.638,7.3,197,60,138,0.305,384,0.513,22,0.544,7.7
73,2365,Chris Andersen,1610612748,MIA,59,26,33,1102.0,74,52,19,0.703,213,0.347,5,0.356,5.2,217,100,115,0.461,410,0.529,44,0.593,3.8,291,152,134,0.522,623,0.467,49,0.507,4.2
74,2547,Chris Bosh,1610612748,MIA,44,19,25,1556.0,46,27,15,0.587,127,0.362,5,0.377,9.8,264,95,167,0.36,449,0.588,35,0.638,5.1,310,122,182,0.394,576,0.538,40,0.578,5.8
75,203142,Chris Copeland,1610612754,IND,50,19,31,828.0,23,17,7,0.739,89,0.258,2,0.264,7.6,88,19,68,0.216,149,0.591,16,0.662,5.6,111,36,75,0.324,238,0.466,18,0.505,6.1
76,201604,Chris Douglas-Roberts,1610612746,LAC,12,5,7,103.0,1,0,1,0.0,7,0.143,0,0.143,20.9,11,4,7,0.364,13,0.846,0,0.846,6.6,12,4,8,0.333,20,0.6,0,0.6,7.8
77,203187,Chris Johnson,1610612762,UTA,29,9,20,527.0,8,3,5,0.375,35,0.229,1,0.235,5.5,47,14,33,0.298,98,0.48,11,0.54,8.0,55,17,38,0.309,133,0.414,12,0.455,7.6
78,2549,Chris Kaman,1610612757,POR,74,47,27,1398.0,149,105,41,0.705,334,0.446,6,0.454,5.8,335,162,170,0.484,565,0.593,36,0.633,4.0,484,267,211,0.552,899,0.538,42,0.565,4.5
79,101108,Chris Paul,1610612746,LAC,82,56,26,2857.0,52,21,29,0.404,206,0.252,6,0.26,15.7,324,60,267,0.185,589,0.55,41,0.591,9.6,376,81,296,0.215,795,0.473,47,0.503,10.5
80,101236,Chuck Hayes,1610612761,TOR,29,17,12,255.0,18,11,7,0.611,52,0.346,3,0.367,5.2,33,19,14,0.576,77,0.429,9,0.485,4.1,51,30,21,0.588,129,0.395,12,0.436,4.5
81,203921,Cleanthony Early,1610612752,NYK,39,6,33,647.0,22,13,8,0.591,70,0.314,4,0.333,12.3,75,25,52,0.333,153,0.49,22,0.573,5.8,97,38,60,0.392,223,0.435,26,0.492,7.2
82,203991,Clint Capela,1610612745,HOU,12,8,4,90.0,10,7,2,0.7,23,0.435,1,0.455,6.1,26,17,9,0.654,41,0.634,5,0.722,5.5,36,24,11,0.667,64,0.563,6,0.621,5.7
83,203469,Cody Zeller,1610612766,CHA,62,27,35,1487.0,97,55,37,0.567,287,0.338,8,0.348,6.5,265,93,172,0.351,487,0.544,43,0.597,5.2,362,148,209,0.409,774,0.468,51,0.501,5.5
84,202332,Cole Aldrich,1610612752,NYK,60,11,49,962.0,100,64,33,0.64,233,0.429,4,0.437,6.2,234,95,140,0.406,377,0.621,28,0.67,3.5,334,159,173,0.476,610,0.548,32,0.578,4.3
85,201147,Corey Brewer,1610612745,HOU,79,42,37,2063.0,80,41,37,0.513,238,0.336,11,0.352,9.5,213,52,162,0.244,392,0.543,29,0.587,8.8,293,93,199,0.317,630,0.465,40,0.497,9.0
86,203928,Cory Jefferson,1610612751,BKN,50,18,32,531.0,47,34,13,0.723,108,0.435,2,0.443,6.5,98,26,71,0.265,174,0.563,10,0.598,4.7,145,60,84,0.414,282,0.514,12,0.537,5.2
87,202709,Cory Joseph,1610612759,SAS,79,53,26,1444.0,44,23,20,0.523,157,0.28,7,0.293,11.7,148,36,113,0.243,268,0.552,23,0.604,8.3,192,59,133,0.307,425,0.452,30,0.486,9.1
88,201584,Courtney Lee,1610612763,MEM,77,51,26,2354.0,21,6,15,0.286,93,0.226,3,0.233,12.6,157,25,134,0.159,296,0.53,16,0.561,10.0,178,31,149,0.174,389,0.458,19,0.481,10.3
89,201571,D.J. Augustin,1610612760,OKC,82,37,45,1964.0,20,7,13,0.35,120,0.167,5,0.174,20.0,141,13,132,0.092,249,0.566,15,0.603,12.0,161,20,145,0.124,369,0.436,20,0.461,13.0
90,2563,Dahntay Jones,1610612746,LAC,33,23,10,123.0,1,0,1,0.0,7,0.143,0,0.143,1.4,10,5,5,0.5,13,0.769,1,0.833,5.8,11,5,6,0.455,20,0.55,1,0.579,5.4
91,203081,Damian Lillard,1610612757,POR,82,51,31,2925.0,49,15,36,0.306,232,0.211,11,0.222,14.6,329,49,282,0.149,612,0.538,50,0.585,7.4,378,64,318,0.169,844,0.448,61,0.483,8.3
92,204014,Damjan Rudez,1610612754,IND,68,28,40,1047.0,8,2,6,0.25,41,0.195,0,0.195,13.7,39,11,29,0.282,86,0.453,6,0.488,11.1,47,13,35,0.277,127,0.37,6,0.388,11.5
93,201568,Danilo Gallinari,1610612743,DEN,59,23,36,1426.0,31,16,15,0.516,128,0.242,6,0.254,9.9,187,35,152,0.187,334,0.56,25,0.605,6.5,218,51,167,0.234,462,0.472,31,0.506,7.0
94,101122,Danny Granger,1610612756,PHX,29,10,19,590.0,20,15,5,0.75,62,0.323,2,0.333,12.0,53,18,37,0.34,124,0.427,17,0.495,7.9,73,33,42,0.452,186,0.392,19,0.437,8.9
95,201980,Danny Green,1610612759,SAS,81,55,26,2312.0,54,21,30,0.389,160,0.338,13,0.367,13.3,289,90,198,0.311,561,0.515,42,0.557,5.7,343,111,228,0.324,721,0.476,55,0.515,6.8
96,201967,Dante Cunningham,1610612740,NOP,66,37,29,1652.0,70,34,35,0.486,214,0.327,11,0.345,9.3,186,52,133,0.28,344,0.541,23,0.579,6.6,256,86,168,0.336,558,0.459,34,0.489,7.4
97,203957,Dante Exum,1610612762,UTA,82,38,44,1817.0,27,5,21,0.185,82,0.329,2,0.338,16.7,104,14,88,0.135,231,0.45,15,0.481,11.0,131,19,109,0.145,313,0.419,17,0.443,12.2
98,203121,Darius Miller,1610612740,NOP,5,1,4,43.0,0,0,0,0.0,1,0.0,0,0.0,0.0,1,1,0,1.0,5,0.2,0,0.2,3.6,1,1,0,1.0,6,0.167,0,0.167,3.6
99,202721,Darius Morris,1610612751,BKN,38,14,24,299.0,7,4,3,0.571,26,0.269,0,0.269,15.0,20,3,18,0.15,40,0.5,3,0.541,11.6,27,7,21,0.259,66,0.409,3,0.429,12.5
100,201589,Darrell Arthur,1610612743,DEN,58,22,36,988.0,53,31,22,0.585,111,0.477,0,0.477,7.8,118,50,68,0.424,275,0.429,31,0.484,5.3,171,81,90,0.474,386,0.443,31,0.482,6.1
101,201954,Darren Collison,1610612758,SAC,45,16,29,1565.0,19,4,15,0.211,99,0.192,5,0.202,17.3,124,14,110,0.113,244,0.508,22,0.559,10.5,143,18,125,0.126,343,0.417,27,0.453,11.4
102,101135,David Lee,1610612744,GSW,49,37,12,904.0,81,51,28,0.63,195,0.415,5,0.426,6.7,176,75,98,0.426,281,0.626,18,0.669,4.4,257,126,126,0.49,476,0.54,23,0.567,5.1
103,204065,David Stockton,1610612758,SAC,3,1,2,33.0,0,0,0,0.0,3,0.0,0,0.0,0.0,2,0,2,0.0,7,0.286,0,0.286,11.4,2,0,2,0.0,10,0.2,0,0.2,11.4
104,204033,David Wear,1610612758,SAC,2,0,2,7.0,2,1,1,0.5,4,0.5,0,0.5,9.8,0,0,0,0.0,1,0.0,0,0.0,0.0,2,1,1,0.5,5,0.4,0,0.4,9.8
105,2561,David West,1610612754,IND,66,32,34,1895.0,108,73,31,0.676,234,0.462,8,0.478,7.4,341,102,238,0.299,557,0.612,36,0.655,5.4,449,175,269,0.39,791,0.568,44,0.601,5.8
106,201599,DeAndre Jordan,1610612746,LAC,82,56,26,2820.0,397,281,105,0.708,744,0.534,12,0.542,5.3,829,270,551,0.326,1163,0.713,77,0.763,4.6,1226,551,656,0.449,1907,0.643,89,0.674,4.8
107,201971,DeJuan Blair,1610612764,WAS,29,15,14,180.0,16,14,2,0.875,52,0.308,1,0.314,4.3,40,16,24,0.4,65,0.615,9,0.714,4.1,56,30,26,0.536,117,0.479,10,0.523,4.1
108,201942,DeMar DeRozan,1610612761,TOR,60,37,23,2100.0,41,15,26,0.366,158,0.259,4,0.266,14.8,236,56,177,0.237,372,0.634,29,0.688,7.2,277,71,203,0.256,530,0.523,33,0.557,8.3
109,202326,DeMarcus Cousins,1610612758,SAC,59,23,36,2013.0,185,138,34,0.746,449,0.412,8,0.42,5.2,562,231,333,0.411,837,0.671,46,0.71,4.2,747,369,367,0.494,1286,0.581,54,0.606,4.4
110,201960,DeMarre Carroll,1610612737,ATL,70,53,17,2189.0,99,56,43,0.566,264,0.375,11,0.391,9.3,273,49,223,0.179,441,0.619,43,0.686,6.9,372,105,266,0.282,705,0.528,54,0.571,7.6
111,203471,Dennis Schroder,1610612737,ATL,77,57,20,1516.0,29,12,17,0.414,135,0.215,6,0.225,14.2,135,15,121,0.111,275,0.491,24,0.538,8.1,164,27,138,0.165,410,0.4,30,0.432,9.2
112,101114,Deron Williams,1610612751,BKN,68,34,34,2114.0,29,12,18,0.414,132,0.22,5,0.228,13.9,208,24,183,0.115,400,0.52,31,0.564,9.0,237,36,201,0.152,532,0.445,36,0.478,9.6
113,202324,Derrick Favors,1610612762,UTA,74,33,41,2280.0,196,159,34,0.811,433,0.453,14,0.468,5.6,411,200,213,0.487,719,0.572,55,0.619,4.8,607,359,247,0.591,1152,0.527,69,0.56,5.1
114,201565,Derrick Rose,1610612741,CHI,51,33,18,1530.0,35,20,14,0.571,163,0.215,11,0.23,10.0,126,14,112,0.111,259,0.486,14,0.514,10.1,161,34,126,0.211,422,0.382,25,0.406,10.0
115,202682,Derrick Williams,1610612758,SAC,74,27,47,1462.0,41,23,17,0.561,122,0.336,6,0.353,8.0,161,35,126,0.217,249,0.647,20,0.703,6.9,202,58,143,0.287,371,0.544,26,0.586,7.1
116,2734,Devin Harris,1610612742,DAL,76,45,31,1685.0,13,5,7,0.385,80,0.163,7,0.178,17.0,122,24,98,0.197,261,0.467,20,0.506,9.3,135,29,105,0.215,341,0.396,27,0.43,10.0
117,203906,Devyn Marble,1610612753,ORL,16,3,13,208.0,5,0,4,0.0,15,0.333,1,0.357,17.3,26,3,23,0.115,37,0.703,0,0.703,8.2,31,3,27,0.097,52,0.596,1,0.608,9.4
118,203473,Dewayne Dedmon,1610612753,ORL,59,17,42,845.0,118,83,27,0.703,200,0.59,3,0.599,5.1,177,77,97,0.435,286,0.619,37,0.711,4.3,295,160,124,0.542,486,0.607,40,0.661,4.6
119,203079,Dion Waiters,1610612760,OKC,79,46,33,2180.0,40,13,28,0.325,161,0.248,5,0.256,15.1,146,23,124,0.158,272,0.537,19,0.577,10.5,186,36,152,0.194,433,0.43,24,0.455,11.5
120,1717,Dirk Nowitzki,1610612742,DAL,77,47,30,2282.0,44,25,19,0.568,156,0.282,5,0.291,8.3,413,174,236,0.421,674,0.613,54,0.666,4.3,457,199,255,0.435,830,0.551,59,0.593,4.7
121,202388,Donald Sloan,1610612754,IND,53,22,31,1107.0,12,1,11,0.083,56,0.214,4,0.231,16.9,131,16,115,0.122,222,0.59,17,0.639,8.6,143,17,126,0.119,278,0.514,21,0.556,9.3
122,202700,Donatas Motiejunas,1610612745,HOU,70,47,23,2006.0,133,87,43,0.654,368,0.361,13,0.375,7.7,281,118,165,0.42,632,0.445,49,0.482,4.6,414,205,208,0.495,1000,0.414,62,0.441,5.6
123,2748,Dorell Wright,1610612757,POR,48,28,20,592.0,14,9,5,0.643,40,0.35,1,0.359,8.5,97,23,73,0.237,150,0.647,16,0.724,6.2,111,32,78,0.288,190,0.584,17,0.642,6.5
124,203926,Doug McDermott,1610612741,CHI,36,23,13,321.0,6,3,2,0.5,27,0.222,3,0.25,7.5,37,7,30,0.189,58,0.638,5,0.698,6.5,43,10,32,0.233,85,0.506,8,0.558,6.6
125,203110,Draymond Green,1610612744,GSW,79,64,15,2490.0,114,83,25,0.728,235,0.485,9,0.504,6.8,533,221,302,0.415,854,0.624,53,0.665,4.4,647,304,327,0.47,1089,0.594,62,0.63,4.8
126,2400,Drew Gooden,1610612764,WAS,51,31,20,864.0,72,49,21,0.681,165,0.436,3,0.444,5.5,151,46,106,0.305,243,0.621,13,0.657,4.7,223,95,127,0.426,408,0.547,16,0.569,5.0
127,204079,Drew Gordon,1610612755,PHI,9,0,9,71.0,7,4,3,0.571,16,0.438,1,0.467,6.0,11,5,6,0.455,24,0.458,2,0.5,4.2,18,9,9,0.5,40,0.45,3,0.486,4.9
128,202779,Dwight Buycks,1610612747,LAL,6,1,5,123.0,2,1,1,0.5,11,0.182,1,0.2,16.5,10,2,8,0.2,18,0.556,0,0.556,9.1,12,3,9,0.25,29,0.414,1,0.429,10.3
129,2730,Dwight Howard,1610612745,HOU,40,28,12,1189.0,108,79,30,0.731,261,0.414,10,0.43,4.5,313,136,177,0.435,476,0.658,37,0.713,3.5,421,215,207,0.511,737,0.571,47,0.61,3.8
130,203939,Dwight Powell,1610612742,DAL,29,11,18,236.0,18,10,7,0.556,49,0.367,1,0.375,6.9,32,7,25,0.219,51,0.627,3,0.667,5.6,50,17,32,0.34,100,0.5,4,0.521,6.0
131,2548,Dwyane Wade,1610612748,MIA,61,27,34,1934.0,57,36,20,0.632,181,0.315,9,0.331,9.0,157,40,119,0.255,307,0.511,20,0.547,8.1,214,76,139,0.355,488,0.439,29,0.466,8.4
132,202734,E'Twaun Moore,1610612741,CHI,56,36,20,504.0,12,5,7,0.417,52,0.231,0,0.231,11.1,34,9,25,0.265,71,0.479,6,0.523,10.2,46,14,32,0.304,123,0.374,6,0.393,10.5
133,2853,Earl Barron,1610612756,PHX,16,5,11,143.0,14,10,5,0.714,41,0.341,3,0.368,3.8,14,5,9,0.357,32,0.438,5,0.519,5.4,28,15,14,0.536,73,0.384,8,0.431,4.6
134,201947,Earl Clark,1610612751,BKN,10,6,4,93.0,1,1,0,1.0,5,0.2,0,0.2,3.8,22,6,16,0.273,36,0.611,4,0.688,3.5,23,7,16,0.304,41,0.561,4,0.622,3.5
135,202334,Ed Davis,1610612747,LAL,79,20,59,1840.0,230,163,63,0.709,500,0.46,12,0.471,4.8,370,122,247,0.33,617,0.6,62,0.667,4.9,600,285,310,0.475,1117,0.537,74,0.575,4.8
136,202327,Ekpe Udoh,1610612746,LAC,33,24,9,128.0,7,4,3,0.571,18,0.389,0,0.389,10.8,19,11,8,0.579,40,0.475,5,0.543,5.4,26,15,11,0.577,58,0.448,5,0.491,6.8
137,203901,Elfrid Payton,1610612753,ORL,82,25,57,2489.0,107,50,55,0.467,372,0.288,19,0.303,8.6,242,41,199,0.169,431,0.561,35,0.611,8.1,349,91,254,0.261,803,0.435,54,0.466,8.3
138,202407,Elijah Millsap,1610612762,UTA,47,25,22,924.0,28,15,11,0.536,73,0.384,7,0.424,7.7,122,27,95,0.221,240,0.508,26,0.57,7.9,150,42,106,0.28,313,0.479,33,0.536,7.9
139,202343,Elliot Williams,1610612755,PHI,13,6,7,119.0,0,0,0,0.0,8,0.0,0,0.0,0.0,8,0,8,0.0,17,0.471,3,0.571,7.6,8,0,8,0.0,25,0.32,3,0.364,7.6
140,1882,Elton Brand,1610612737,ATL,36,25,11,486.0,28,18,7,0.643,68,0.412,4,0.438,5.1,72,35,39,0.486,146,0.493,17,0.558,5.3,100,53,46,0.53,214,0.467,21,0.518,5.2
141,202683,Enes Kanter,1610612760,OKC,75,32,43,2136.0,277,219,47,0.791,662,0.418,15,0.428,4.0,394,146,242,0.371,669,0.589,61,0.648,4.6,671,365,289,0.544,1331,0.504,76,0.535,4.4
142,202339,Eric Bledsoe,1610612756,PHX,81,39,42,2800.0,72,38,37,0.528,253,0.285,13,0.3,11.1,351,66,287,0.188,664,0.529,51,0.573,7.5,423,104,324,0.246,917,0.461,64,0.496,8.2
143,201569,Eric Gordon,1610612740,NOP,61,35,26,2018.0,28,12,17,0.429,102,0.275,4,0.286,15.7,131,17,114,0.13,242,0.541,19,0.587,8.9,159,29,131,0.182,344,0.462,23,0.495,10.2
144,203961,Eric Moreland,1610612758,SAC,3,0,3,2.0,0,0,0,0.0,0,0.0,0,0.0,0.0,1,1,1,1.0,0,0.0,0,0.0,3.9,1,1,1,1.0,0,0.0,0,0.0,3.9
145,203475,Erick Green,1610612743,DEN,43,15,28,410.0,7,3,4,0.429,18,0.389,0,0.389,13.0,24,3,23,0.125,44,0.545,3,0.585,9.3,31,6,27,0.194,62,0.5,3,0.525,10.1
146,101141,Ersan Ilyasova,1610612749,MIL,57,25,32,1307.0,80,63,14,0.788,204,0.392,6,0.404,4.6,195,86,108,0.441,347,0.562,28,0.611,5.3,275,149,122,0.542,551,0.499,34,0.532,5.1
147,203095,Evan Fournier,1610612753,ORL,58,19,39,1661.0,28,9,19,0.321,131,0.214,12,0.235,12.8,125,29,96,0.232,236,0.53,18,0.573,10.1,153,38,115,0.248,367,0.417,30,0.454,10.6
148,202323,Evan Turner,1610612738,BOS,82,40,42,2260.0,40,22,17,0.55,186,0.215,7,0.223,9.6,377,84,289,0.223,601,0.627,45,0.678,5.3,417,106,306,0.254,787,0.53,52,0.567,5.8
149,203105,Festus Ezeli,1610612744,GSW,46,39,7,504.0,60,45,14,0.75,151,0.397,5,0.411,4.0,95,44,48,0.463,187,0.508,15,0.552,3.9,155,89,62,0.574,338,0.459,20,0.487,3.9
150,101128,Francisco Garcia,1610612745,HOU,14,10,4,200.0,3,3,0,1.0,16,0.188,0,0.188,11.8,14,2,12,0.143,30,0.467,3,0.519,7.9,17,5,12,0.294,46,0.37,3,0.395,8.6
151,203128,Furkan Aldemir,1610612755,PHI,41,9,32,540.0,78,57,19,0.731,179,0.436,6,0.451,5.0,98,36,58,0.367,162,0.605,16,0.671,4.4,176,93,77,0.528,341,0.516,22,0.552,4.6
152,203539,Gal Mekel,1610612742,DAL,4,2,2,43.0,0,0,0,0.0,4,0.0,0,0.0,0.0,1,0,1,0.0,3,0.333,0,0.333,8.4,1,0,1,0.0,7,0.143,0,0.143,8.4
153,202066,Garrett Temple,1610612764,WAS,52,28,24,736.0,24,7,16,0.292,52,0.462,2,0.48,17.9,66,13,53,0.197,134,0.493,12,0.541,8.3,90,20,69,0.222,186,0.484,14,0.523,10.9
154,203914,Gary Harris,1610612743,DEN,55,18,37,719.0,21,10,12,0.476,70,0.3,5,0.323,14.3,43,9,33,0.209,84,0.512,4,0.538,7.4,64,19,45,0.297,154,0.416,9,0.441,9.8
155,202390,Gary Neal,1610612750,MIN,54,24,30,1192.0,14,5,8,0.357,74,0.189,3,0.197,15.1,115,16,99,0.139,206,0.558,18,0.612,8.4,129,21,107,0.163,280,0.461,21,0.498,9.1
156,201588,George Hill,1610612754,IND,43,26,17,1267.0,25,8,16,0.32,91,0.275,7,0.298,11.5,154,26,128,0.169,258,0.597,22,0.653,7.7,179,34,144,0.19,349,0.513,29,0.559,8.2
157,101123,Gerald Green,1610612756,PHX,74,34,40,1446.0,33,11,21,0.333,106,0.311,8,0.337,13.2,153,33,117,0.216,271,0.565,18,0.605,7.9,186,44,138,0.237,377,0.493,26,0.53,8.9
158,201945,Gerald Henderson,1610612766,CHA,80,32,48,2315.0,36,9,28,0.25,148,0.243,2,0.247,17.4,237,35,203,0.148,401,0.591,28,0.635,7.9,273,44,231,0.161,549,0.497,30,0.526,9.3
159,2222,Gerald Wallace,1610612738,BOS,32,15,17,286.0,17,13,4,0.765,47,0.362,0,0.362,5.4,40,4,36,0.1,69,0.58,9,0.667,6.9,57,17,40,0.298,116,0.491,9,0.533,6.4
160,203507,Giannis Antetokounmpo,1610612749,MIL,80,40,40,2508.0,99,65,35,0.657,301,0.329,10,0.34,8.0,438,137,300,0.313,694,0.631,59,0.69,5.8,537,202,335,0.376,995,0.54,69,0.58,6.2
161,203540,Gigi Datome,1610612738,BOS,21,11,10,209.0,3,3,0,1.0,21,0.143,1,0.15,5.7,26,7,19,0.269,50,0.52,4,0.565,6.3,29,10,19,0.345,71,0.408,5,0.439,6.2
162,201175,Glen Davis,1610612746,LAC,74,52,22,904.0,43,31,12,0.721,157,0.274,3,0.279,5.7,126,72,53,0.571,260,0.485,27,0.541,5.3,169,103,65,0.609,417,0.405,30,0.437,5.4
163,203318,Glen Rice,1610612764,WAS,5,4,1,43.0,2,1,1,0.5,5,0.4,0,0.4,17.8,2,1,1,0.5,4,0.5,0,0.5,2.4,4,2,2,0.5,9,0.444,0,0.444,10.1
164,203922,Glenn Robinson III,1610612755,PHI,35,2,33,261.0,15,11,4,0.733,39,0.385,0,0.385,8.6,24,4,20,0.167,46,0.522,5,0.585,6.4,39,15,24,0.385,85,0.459,5,0.488,7.3
165,201609,Goran Dragic,1610612748,MIA,78,41,37,2640.0,81,38,42,0.469,256,0.316,8,0.327,12.2,193,34,157,0.176,420,0.46,30,0.495,10.8,274,72,199,0.263,676,0.405,38,0.429,11.2
166,202330,Gordon Hayward,1610612762,UTA,76,35,41,2618.0,54,23,30,0.426,198,0.273,8,0.284,12.8,319,50,269,0.157,480,0.665,32,0.712,8.3,373,73,299,0.196,678,0.55,40,0.585,8.9
167,203476,Gorgui Dieng,1610612750,MIN,72,16,56,2179.0,222,142,79,0.64,477,0.465,12,0.477,6.2,384,147,233,0.383,677,0.567,54,0.616,4.4,606,289,312,0.477,1154,0.525,66,0.557,5.1
168,203511,Grant Jerrett,1610612762,UTA,8,6,2,51.0,2,0,2,0.0,6,0.333,0,0.333,15.3,7,1,6,0.143,8,0.875,2,1.167,5.7,9,1,8,0.111,14,0.643,2,0.75,7.8
169,202328,Greg Monroe,1610612765,DET,69,25,44,2137.0,229,169,58,0.738,509,0.45,12,0.461,5.6,475,176,292,0.371,709,0.67,51,0.722,4.7,704,345,350,0.49,1218,0.578,63,0.61,5.0
170,202962,Greg Smith,1610612742,DAL,42,27,15,363.0,26,17,9,0.654,68,0.382,1,0.388,6.1,53,19,34,0.358,110,0.482,14,0.552,4.1,79,36,43,0.456,178,0.444,15,0.485,4.7
171,201880,Greg Stiemsma,1610612761,TOR,17,13,4,66.0,9,3,6,0.333,14,0.643,0,0.643,7.2,6,3,3,0.5,10,0.6,0,0.6,3.5,15,6,9,0.4,24,0.625,0,0.625,5.7
172,202349,Greivis Vasquez,1610612761,TOR,82,49,33,1991.0,22,5,17,0.227,135,0.163,4,0.168,17.9,194,24,169,0.124,377,0.515,23,0.548,8.6,216,29,186,0.134,512,0.422,27,0.445,9.6
173,203084,Harrison Barnes,1610612744,GSW,82,67,15,2318.0,117,58,60,0.496,306,0.382,9,0.394,9.8,336,90,245,0.268,616,0.545,56,0.6,6.1,453,148,305,0.327,922,0.491,65,0.529,7.1
174,202355,Hassan Whiteside,1610612748,MIA,47,17,30,1134.0,144,124,17,0.861,341,0.422,2,0.425,4.1,335,153,177,0.457,528,0.634,40,0.686,3.7,479,277,194,0.578,869,0.551,42,0.579,3.8
175,2045,Hedo Turkoglu,1610612746,LAC,62,42,20,705.0,5,1,4,0.2,34,0.147,2,0.156,13.3,94,24,70,0.255,150,0.627,11,0.676,5.5,99,25,74,0.253,184,0.538,13,0.579,5.9
176,203156,Henry Sims,1610612755,PHI,73,14,59,1399.0,121,89,32,0.736,339,0.357,11,0.369,6.0,238,104,136,0.437,446,0.534,40,0.586,4.5,359,193,168,0.538,785,0.457,51,0.489,5.0
177,201611,Henry Walker,1610612748,MIA,24,12,12,628.0,7,2,5,0.286,28,0.25,2,0.269,13.3,75,28,48,0.373,159,0.472,21,0.543,6.5,82,30,53,0.366,187,0.439,23,0.5,7.1
178,203138,Hollis Thompson,1610612755,PHI,71,13,58,1776.0,53,24,26,0.453,129,0.411,6,0.431,12.0,145,43,103,0.297,267,0.543,22,0.592,8.3,198,67,129,0.338,396,0.5,28,0.538,9.3
179,203546,Ian Clark,1610612743,DEN,30,9,21,192.0,4,1,3,0.25,11,0.364,0,0.364,15.6,12,2,10,0.167,27,0.444,2,0.48,12.3,16,3,13,0.188,38,0.421,2,0.444,13.1
180,101133,Ian Mahinmi,1610612754,IND,61,28,33,1146.0,105,82,23,0.781,234,0.449,7,0.463,5.1,251,101,148,0.402,387,0.649,28,0.699,4.9,356,183,171,0.514,621,0.573,35,0.608,5.0
181,202697,Iman Shumpert,1610612739,CLE,62,34,28,1545.0,55,19,34,0.345,128,0.43,4,0.444,13.2,169,33,138,0.195,268,0.631,16,0.671,7.3,224,52,172,0.232,396,0.566,20,0.596,8.7
182,203477,Isaiah Canaan,1610612755,PHI,46,23,23,912.0,18,1,16,0.056,59,0.305,3,0.321,18.9,67,9,59,0.134,124,0.54,8,0.578,9.2,85,10,75,0.118,183,0.464,11,0.494,11.1
183,202738,Isaiah Thomas,1610612738,BOS,67,40,27,1726.0,33,14,20,0.424,139,0.237,7,0.25,12.8,120,21,101,0.175,230,0.522,9,0.543,11.8,153,35,121,0.229,369,0.415,16,0.433,12.1
184,202397,Ish Smith,1610612755,PHI,55,24,31,831.0,15,3,12,0.2,72,0.208,5,0.224,8.4,85,13,73,0.153,185,0.459,13,0.494,8.5,100,16,85,0.16,257,0.389,18,0.418,8.5
185,200826,J.J. Barea,1610612742,DAL,77,49,28,1362.0,23,11,12,0.478,115,0.2,8,0.215,10.4,111,10,101,0.09,227,0.489,20,0.536,10.1,134,21,113,0.157,342,0.392,28,0.427,10.2
186,201581,JJ Hickson,1610612743,DEN,73,26,47,1411.0,150,96,44,0.64,340,0.441,6,0.449,5.5,302,92,207,0.305,449,0.673,32,0.724,5.0,452,188,251,0.416,789,0.573,38,0.602,5.2
187,200755,JJ Redick,1610612746,LAC,78,55,23,2409.0,22,1,19,0.045,101,0.218,4,0.227,19.0,145,18,126,0.124,307,0.472,38,0.539,10.4,167,19,145,0.114,408,0.409,42,0.456,11.4
188,2747,JR Smith,1610612739,CLE,70,38,32,2079.0,30,9,20,0.3,113,0.265,12,0.297,14.9,188,37,150,0.197,300,0.627,21,0.674,9.2,218,46,170,0.211,413,0.528,33,0.574,10.0
189,203960,JaKarr Sampson,1610612755,PHI,74,17,57,1131.0,35,12,21,0.343,101,0.347,4,0.361,11.7,128,24,102,0.188,245,0.522,18,0.564,6.3,163,36,123,0.221,346,0.471,22,0.503,7.4
190,203210,JaMychal Green,1610612763,MEM,24,10,14,164.0,19,9,10,0.474,34,0.559,0,0.559,6.6,26,11,15,0.423,37,0.703,3,0.765,4.9,45,20,25,0.444,71,0.634,3,0.662,5.6
191,201580,JaVale McGee,1610612743,DEN,23,8,15,256.0,18,11,6,0.611,45,0.4,1,0.409,7.1,43,15,27,0.349,86,0.5,10,0.566,3.8,61,26,33,0.426,131,0.466,11,0.508,4.8
192,203913,Jabari Brown,1610612747,LAL,19,4,15,568.0,3,1,2,0.333,36,0.083,2,0.088,15.0,33,3,30,0.091,71,0.465,8,0.524,9.1,36,4,32,0.111,107,0.336,10,0.371,9.6
193,203953,Jabari Parker,1610612749,MIL,25,13,12,738.0,50,20,26,0.4,99,0.505,3,0.521,9.4,88,33,50,0.375,176,0.5,13,0.54,5.6,138,53,76,0.384,275,0.502,16,0.533,7.0
194,204022,Jack Cooley,1610612762,UTA,16,10,6,87.0,10,8,2,0.8,24,0.417,3,0.476,4.4,15,8,7,0.533,25,0.6,3,0.682,4.2,25,16,9,0.64,49,0.51,6,0.581,4.3
195,203109,Jae Crowder,1610612738,BOS,82,47,35,1647.0,72,34,36,0.472,190,0.379,10,0.4,8.8,221,68,150,0.308,360,0.614,31,0.672,6.4,293,102,186,0.348,550,0.533,41,0.576,7.0
196,203479,Jamaal Franklin,1610612743,DEN,3,1,2,13.0,1,1,0,1.0,2,0.5,0,0.5,9.0,1,0,1,0.0,1,1.0,0,1.0,12.0,2,1,1,0.5,3,0.667,0,0.667,10.5
197,2037,Jamal Crawford,1610612746,LAC,64,44,20,1703.0,18,8,7,0.444,68,0.265,4,0.281,9.8,106,17,92,0.16,177,0.599,4,0.613,10.9,124,25,99,0.202,245,0.506,8,0.523,10.8
198,2749,Jameer Nelson,1610612743,DEN,63,25,38,1406.0,33,10,22,0.303,87,0.379,4,0.398,12.5,113,21,91,0.186,240,0.471,20,0.514,8.6,146,31,113,0.212,327,0.446,24,0.482,9.5
199,203516,James Ennis III,1610612748,MIA,62,27,35,1051.0,51,27,21,0.529,141,0.362,6,0.378,7.2,125,37,89,0.296,219,0.571,28,0.654,6.3,176,64,110,0.364,360,0.489,34,0.54,6.5
200,201935,James Harden,1610612745,HOU,80,55,25,2941.0,74,39,35,0.527,295,0.251,14,0.263,9.5,381,84,296,0.22,631,0.604,49,0.655,7.7,455,123,331,0.27,926,0.491,63,0.527,8.0
201,201949,James Johnson,1610612761,TOR,70,40,30,1370.0,61,37,25,0.607,174,0.351,5,0.361,8.6,196,53,146,0.27,322,0.609,23,0.656,5.2,257,90,171,0.35,496,0.518,28,0.549,6.0
202,2592,James Jones,1610612739,CLE,56,35,21,665.0,9,2,7,0.222,29,0.31,1,0.321,19.3,52,16,36,0.308,106,0.491,10,0.542,6.2,61,18,43,0.295,135,0.452,11,0.492,8.2
203,203949,James Michael McAdoo,1610612744,GSW,15,11,4,137.0,15,9,6,0.6,29,0.517,1,0.536,8.0,22,9,13,0.409,45,0.489,4,0.537,4.7,37,18,19,0.486,74,0.5,5,0.536,6.0
204,203923,James Young,1610612738,BOS,31,14,17,332.0,9,2,6,0.222,24,0.375,2,0.409,16.6,33,9,22,0.273,54,0.611,6,0.688,6.2,42,11,28,0.262,78,0.538,8,0.6,8.4
205,2457,Jannero Pargo,1610612766,CHA,9,2,7,73.0,0,0,0,0.0,5,0.0,0,0.0,0.0,3,1,3,0.333,8,0.375,0,0.375,5.0,3,1,3,0.333,13,0.231,0,0.231,5.0
206,203099,Jared Cunningham,1610612746,LAC,19,12,7,89.0,1,1,0,1.0,5,0.2,0,0.2,7.0,8,3,5,0.375,16,0.5,3,0.615,7.6,9,4,5,0.444,21,0.429,3,0.5,7.5
207,201162,Jared Dudley,1610612749,MIL,71,38,33,1694.0,43,24,18,0.558,128,0.336,5,0.35,8.9,172,54,119,0.314,410,0.42,40,0.465,6.8,215,78,137,0.363,538,0.4,45,0.436,7.2
208,203096,Jared Sullinger,1610612738,BOS,58,26,32,1566.0,147,109,34,0.741,345,0.426,8,0.436,5.1,294,123,172,0.418,498,0.59,42,0.645,4.6,441,232,206,0.526,843,0.523,50,0.556,4.7
209,203950,Jarnell Stokes,1610612763,MEM,19,12,7,126.0,16,12,3,0.75,44,0.364,3,0.39,3.6,18,3,15,0.167,38,0.474,2,0.5,4.4,34,15,18,0.441,82,0.415,5,0.442,4.1
210,101127,Jarrett Jack,1610612751,BKN,80,36,44,2241.0,19,5,15,0.263,99,0.192,4,0.2,17.8,226,20,207,0.088,391,0.578,25,0.617,9.9,245,25,222,0.102,490,0.5,29,0.531,10.5
211,101131,Jason Maxiell,1610612766,CHA,61,22,39,878.0,86,58,24,0.674,198,0.434,7,0.45,5.7,117,39,76,0.333,257,0.455,29,0.513,5.2,203,97,100,0.478,455,0.446,36,0.484,5.4
212,2202,Jason Richardson,1610612755,PHI,19,4,15,416.0,13,9,4,0.692,35,0.371,3,0.406,4.8,53,9,44,0.17,87,0.609,6,0.654,8.2,66,18,48,0.273,122,0.541,9,0.584,7.6
213,201160,Jason Smith,1610612752,NYK,81,17,64,1770.0,97,59,34,0.608,247,0.393,4,0.399,7.5,223,71,147,0.318,414,0.539,34,0.587,5.3,320,130,181,0.406,661,0.484,38,0.514,6.0
214,1891,Jason Terry,1610612745,HOU,76,52,24,1618.0,15,3,13,0.2,69,0.217,3,0.227,18.9,103,10,93,0.097,215,0.479,18,0.523,11.9,118,13,106,0.11,284,0.415,21,0.449,12.8
215,201574,Jason Thompson,1610612758,SAC,81,29,52,1991.0,139,103,33,0.741,335,0.415,10,0.428,5.8,391,152,236,0.389,651,0.601,53,0.654,4.6,530,255,269,0.481,986,0.538,63,0.574,5.0
216,202399,Jeff Adrien,1610612745,HOU,17,1,16,215.0,23,15,7,0.652,55,0.418,0,0.418,4.8,54,19,34,0.352,76,0.711,8,0.794,3.8,77,34,41,0.442,131,0.588,8,0.626,4.1
217,201965,Jeff Ayres,1610612759,SAS,51,33,18,383.0,37,27,10,0.73,82,0.451,3,0.468,5.5,80,28,51,0.35,131,0.611,8,0.65,4.0,117,55,61,0.47,213,0.549,11,0.579,4.5
218,201145,Jeff Green,1610612763,MEM,78,41,37,2455.0,64,36,28,0.563,207,0.309,2,0.312,10.1,264,71,192,0.269,437,0.604,28,0.645,7.5,328,107,220,0.326,644,0.509,30,0.534,8.0
219,201952,Jeff Teague,1610612737,ATL,73,53,20,2228.0,30,6,27,0.2,170,0.176,9,0.186,15.7,154,21,133,0.136,311,0.495,16,0.522,10.0,184,27,160,0.147,481,0.383,25,0.404,11.1
220,203481,Jeff Withey,1610612740,NOP,37,17,20,259.0,23,15,7,0.652,51,0.451,3,0.479,6.1,41,21,19,0.512,74,0.554,3,0.577,3.6,64,36,26,0.563,125,0.512,6,0.538,4.5
221,203106,Jeffery Taylor,1610612766,CHA,29,11,18,430.0,14,7,7,0.5,46,0.304,0,0.304,12.2,39,8,31,0.205,73,0.534,5,0.574,8.1,53,15,38,0.283,119,0.445,5,0.465,9.2
222,203924,Jerami Grant,1610612755,PHI,65,18,47,1377.0,49,31,18,0.633,148,0.331,8,0.35,10.5,149,42,108,0.282,314,0.475,33,0.53,6.8,198,73,126,0.369,462,0.429,41,0.47,7.7
223,202077,Jerel McNeal,1610612756,PHX,6,1,5,36.0,0,0,0,0.0,1,0.0,0,0.0,0.0,3,1,2,0.333,8,0.375,1,0.429,8.0,3,1,2,0.333,9,0.333,1,0.375,8.0
224,202379,Jeremy Evans,1610612762,UTA,38,19,19,266.0,26,17,8,0.654,64,0.406,4,0.433,5.6,45,23,23,0.511,86,0.523,9,0.584,6.6,71,40,31,0.563,150,0.473,13,0.518,6.2
225,203087,Jeremy Lamb,1610612760,OKC,47,27,20,633.0,8,2,6,0.25,36,0.222,2,0.235,6.6,99,20,78,0.202,142,0.697,7,0.733,6.7,107,22,84,0.206,178,0.601,9,0.633,6.7
226,202391,Jeremy Lin,1610612747,LAL,74,19,55,1907.0,26,7,18,0.269,155,0.168,4,0.172,15.6,170,46,129,0.271,385,0.442,42,0.496,9.2,196,53,147,0.27,540,0.363,46,0.397,10.0
227,202366,Jerome Jordan,1610612751,BKN,44,17,27,383.0,52,36,16,0.692,99,0.525,0,0.525,5.5,53,25,29,0.472,109,0.486,16,0.57,7.9,105,61,45,0.581,208,0.505,16,0.547,6.7
228,203968,Jerrelle Benimon,1610612743,DEN,2,2,0,3.0,1,1,0,1.0,1,1.0,0,1.0,1.9,2,1,1,0.5,2,1.0,0,1.0,4.4,3,2,1,0.667,3,1.0,0,1.0,3.5
229,201573,Jerryd Bayless,1610612749,MIL,76,38,38,1700.0,22,5,14,0.227,105,0.21,5,0.22,14.2,189,32,155,0.169,338,0.559,29,0.612,8.2,211,37,169,0.175,443,0.476,34,0.516,8.8
230,202690,Jimmer Fredette,1610612740,NOP,50,27,23,509.0,8,1,7,0.125,28,0.286,1,0.296,15.1,32,5,28,0.156,69,0.464,6,0.508,10.8,40,6,35,0.15,97,0.412,7,0.444,11.6
231,202710,Jimmy Butler,1610612741,CHI,65,40,25,2513.0,114,66,46,0.579,322,0.354,7,0.362,8.1,265,71,191,0.268,480,0.552,44,0.608,8.4,379,137,237,0.361,802,0.473,51,0.505,8.3
232,201149,Joakim Noah,1610612741,CHI,67,39,28,2049.0,219,174,36,0.795,523,0.419,11,0.428,4.5,427,169,259,0.396,775,0.551,62,0.599,4.3,646,343,295,0.531,1298,0.498,73,0.527,4.4
233,201975,Jodie Meeks,1610612765,DET,60,29,31,1462.0,12,2,10,0.167,71,0.169,4,0.179,19.0,92,12,81,0.13,154,0.597,11,0.643,9.7,104,14,91,0.135,225,0.462,15,0.495,10.8
234,203925,Joe Harris,1610612739,CLE,51,32,19,493.0,7,2,5,0.286,24,0.292,1,0.304,17.6,34,5,29,0.147,72,0.472,6,0.515,8.9,41,7,34,0.171,96,0.427,7,0.461,10.4
235,204060,Joe Ingles,1610612762,UTA,79,36,43,1673.0,22,6,16,0.273,76,0.289,0,0.289,20.6,153,29,127,0.19,252,0.607,12,0.638,9.5,175,35,143,0.2,328,0.534,12,0.554,10.9
236,2207,Joe Johnson,1610612751,BKN,80,38,42,2791.0,53,30,22,0.566,203,0.261,6,0.269,10.6,331,67,262,0.202,451,0.734,34,0.794,7.6,384,97,284,0.253,654,0.587,40,0.625,8.0
237,201202,Joel Anthony,1610612765,DET,49,25,24,406.0,32,22,10,0.688,93,0.344,2,0.352,6.1,61,19,42,0.311,129,0.473,15,0.535,4.5,93,41,52,0.441,222,0.419,17,0.454,5.1
238,200777,Joel Freeland,1610612757,POR,48,34,14,617.0,62,45,16,0.726,144,0.431,2,0.437,5.8,129,50,77,0.388,241,0.535,28,0.606,4.1,191,95,93,0.497,385,0.496,30,0.538,4.7
239,201595,Joey Dorsey,1610612745,HOU,68,47,21,851.0,102,79,22,0.775,269,0.379,10,0.394,5.2,174,76,99,0.437,285,0.611,24,0.667,4.3,276,155,121,0.562,554,0.498,34,0.531,4.6
240,203530,Joffrey Lauvergne,1610612743,DEN,24,9,15,268.0,27,20,3,0.741,73,0.37,1,0.375,3.6,50,20,30,0.4,80,0.625,9,0.704,3.1,77,40,33,0.519,153,0.503,10,0.538,3.3
241,203089,John Henson,1610612749,MIL,66,34,32,1211.0,123,92,30,0.748,227,0.542,6,0.557,5.4,186,89,97,0.478,355,0.524,30,0.572,3.8,309,181,127,0.586,582,0.531,36,0.566,4.4
242,203098,John Jenkins,1610612737,ATL,24,13,11,297.0,2,0,2,0.0,14,0.143,0,0.143,25.8,37,4,32,0.108,73,0.507,3,0.529,8.6,39,4,34,0.103,87,0.448,3,0.464,9.5
243,101249,John Lucas III,1610612765,DET,21,8,13,272.0,4,1,3,0.25,10,0.4,0,0.4,13.0,12,1,11,0.083,33,0.364,1,0.375,12.1,16,2,14,0.125,43,0.372,1,0.381,12.3
244,2422,John Salmons,1610612740,NOP,21,9,12,270.0,4,0,4,0.0,18,0.222,1,0.235,27.0,17,3,14,0.176,33,0.515,3,0.567,9.6,21,3,18,0.143,51,0.412,4,0.447,12.9
245,202322,John Wall,1610612764,WAS,79,45,34,2837.0,36,9,29,0.25,208,0.173,12,0.184,14.2,330,30,299,0.091,538,0.613,34,0.655,9.2,366,39,328,0.107,746,0.491,46,0.523,9.8
246,203948,Johnny O'Bryant III,1610612749,MIL,33,16,17,357.0,25,13,11,0.52,65,0.385,4,0.41,7.1,38,14,24,0.368,90,0.422,8,0.463,5.7,63,27,35,0.429,155,0.406,12,0.441,6.2
247,202720,Jon Leuer,1610612763,MEM,63,45,18,824.0,50,31,17,0.62,138,0.362,4,0.373,6.4,157,62,95,0.395,280,0.561,22,0.609,4.1,207,93,112,0.449,418,0.495,26,0.528,4.7
248,201973,Jonas Jerebko,1610612738,BOS,75,37,38,1230.0,93,60,34,0.645,221,0.421,7,0.435,6.8,189,68,119,0.36,325,0.582,31,0.643,5.2,282,128,153,0.454,546,0.516,38,0.555,5.7
249,202685,Jonas Valanciunas,1610612761,TOR,80,47,33,2096.0,215,171,36,0.795,544,0.395,6,0.4,3.9,478,197,281,0.412,797,0.6,64,0.652,3.7,693,368,317,0.531,1341,0.517,70,0.545,3.8
250,203919,Jordan Adams,1610612763,MEM,30,14,16,248.0,9,5,4,0.556,26,0.346,2,0.375,9.2,19,6,13,0.316,31,0.613,3,0.679,7.0,28,11,17,0.393,57,0.491,5,0.538,7.7
251,203903,Jordan Clarkson,1610612747,LAL,59,11,48,1476.0,56,33,23,0.589,181,0.309,11,0.329,9.4,135,19,117,0.141,275,0.491,30,0.551,8.0,191,52,140,0.272,456,0.419,41,0.46,8.4
252,200770,Jordan Farmar,1610612746,LAC,36,23,13,529.0,8,1,7,0.125,39,0.205,2,0.216,18.0,34,8,25,0.235,84,0.405,7,0.442,8.9,42,9,32,0.214,123,0.341,9,0.368,10.7
253,202706,Jordan Hamilton,1610612746,LAC,14,10,4,122.0,2,2,0,1.0,9,0.222,1,0.25,6.9,14,6,8,0.429,27,0.519,2,0.56,5.3,16,8,8,0.5,36,0.444,3,0.485,5.5
254,201941,Jordan Hill,1610612747,LAL,70,19,51,1874.0,174,117,49,0.672,403,0.432,12,0.445,6.3,382,155,224,0.406,619,0.617,60,0.683,4.3,556,272,273,0.489,1022,0.544,72,0.585,4.9
255,203268,Jorge Gutierrez,1610612749,MIL,20,10,10,174.0,5,1,4,0.2,15,0.333,0,0.333,13.2,20,3,17,0.15,35,0.571,3,0.625,7.3,25,4,21,0.16,50,0.5,3,0.532,8.5
256,101181,Jose Calderon,1610612752,NYK,41,7,34,1233.0,19,0,19,0.0,51,0.373,1,0.38,20.1,102,10,93,0.098,178,0.573,11,0.611,10.4,121,10,112,0.083,229,0.528,12,0.558,11.9
257,201177,Josh McRoberts,1610612748,MIA,17,8,9,296.0,7,5,2,0.714,17,0.412,0,0.412,4.3,38,20,17,0.526,80,0.475,9,0.535,5.4,45,25,19,0.556,97,0.464,9,0.511,5.2
258,2746,Josh Smith,1610612745,HOU,83,41,42,2301.0,152,97,56,0.638,334,0.455,10,0.469,8.3,378,143,230,0.378,688,0.549,59,0.601,5.6,530,240,286,0.453,1022,0.519,69,0.556,6.3
259,201950,Jrue Holiday,1610612740,NOP,40,20,20,1303.0,32,15,17,0.469,103,0.311,3,0.32,12.2,103,22,83,0.214,211,0.488,15,0.526,7.9,135,37,100,0.274,314,0.43,18,0.456,8.8
260,203944,Julius Randle,1610612747,LAL,1,0,1,14.0,0,0,0,0.0,3,0.0,0,0.0,0.0,0,0,0,0.0,1,0.0,0,0.0,0.0,0,0,0,0.0,4,0.0,0,0.0,0.0
261,203120,Justin Hamilton,1610612750,MIN,41,6,35,713.0,57,45,11,0.789,124,0.46,1,0.463,5.5,77,31,47,0.403,197,0.391,27,0.453,6.0,134,76,58,0.567,321,0.417,28,0.457,5.8
262,203200,Justin Holiday,1610612744,GSW,59,49,10,657.0,12,8,6,0.667,54,0.222,0,0.222,6.7,61,10,49,0.164,112,0.545,10,0.598,10.6,73,18,55,0.247,166,0.44,10,0.468,10.2
263,203994,Jusuf Nurkic,1610612743,DEN,62,21,41,1103.0,125,94,27,0.752,308,0.406,8,0.417,4.4,257,119,136,0.463,421,0.61,29,0.656,4.0,382,213,163,0.558,729,0.524,37,0.552,4.2
264,203909,KJ McDaniels,1610612745,HOU,62,19,43,1352.0,65,41,20,0.631,135,0.481,5,0.5,7.6,135,40,96,0.296,294,0.459,36,0.523,7.4,200,81,116,0.405,429,0.466,41,0.515,7.5
265,203564,Kalin Lucas,1610612763,MEM,1,0,1,6.0,0,0,0,0.0,0,0.0,0,0.0,0.0,0,0,0,0.0,0,0.0,0,0.0,0.0,0,0,0,0.0,0,0.0,0,0.0,0.0
266,202695,Kawhi Leonard,1610612759,SAS,64,46,18,2033.0,85,53,32,0.624,186,0.457,9,0.48,9.0,376,104,274,0.277,551,0.682,38,0.733,6.4,461,157,306,0.341,737,0.626,47,0.668,6.9
267,203482,Kelly Olynyk,1610612738,BOS,64,31,33,1423.0,92,54,37,0.587,262,0.351,14,0.371,7.8,211,64,142,0.303,404,0.522,43,0.584,5.6,303,118,179,0.389,666,0.455,57,0.498,6.2
268,202689,Kemba Walker,1610612766,CHA,62,21,41,2119.0,35,15,19,0.429,172,0.203,5,0.21,16.4,185,37,151,0.2,420,0.44,49,0.499,8.6,220,52,170,0.236,592,0.372,54,0.409,9.8
269,203088,Kendall Marshall,1610612749,MIL,27,12,15,414.0,2,0,3,0.0,21,0.095,1,0.1,23.1,25,5,20,0.2,51,0.49,2,0.51,9.6,27,5,23,0.185,72,0.375,3,0.391,11.1
270,2570,Kendrick Perkins,1610612739,CLE,68,38,30,1148.0,91,65,24,0.714,241,0.378,12,0.397,6.6,229,92,136,0.402,398,0.575,40,0.64,3.9,320,157,160,0.491,639,0.501,52,0.545,4.7
271,202702,Kenneth Faried,1610612743,DEN,75,30,45,2086.0,242,167,68,0.69,560,0.432,16,0.445,6.0,426,167,254,0.392,649,0.656,40,0.7,5.1,668,334,322,0.5,1209,0.553,56,0.579,5.5
272,203145,Kent Bazemore,1610612737,ATL,75,53,22,1323.0,21,12,10,0.571,78,0.269,2,0.276,7.7,201,39,158,0.194,341,0.589,33,0.653,6.2,222,51,168,0.23,419,0.53,35,0.578,6.3
273,203484,Kentavious Caldwell-Pope,1610612765,DET,82,32,50,2587.0,46,14,34,0.304,172,0.267,8,0.28,12.0,209,40,169,0.191,382,0.547,41,0.613,9.0,255,54,203,0.212,554,0.46,49,0.505,9.5
274,2030,Kenyon Martin,1610612749,MIL,10,6,4,102.0,5,3,1,0.6,16,0.313,0,0.313,6.4,13,8,5,0.615,25,0.52,3,0.591,4.1,18,11,6,0.611,41,0.439,3,0.474,4.6
275,201142,Kevin Durant,1610612760,OKC,27,18,9,913.0,16,9,6,0.563,60,0.267,2,0.276,10.9,162,39,121,0.241,218,0.743,13,0.79,6.3,178,48,127,0.27,278,0.64,15,0.677,6.7
276,708,Kevin Garnett,1610612750,MIN,47,20,27,952.0,48,24,22,0.5,88,0.545,6,0.585,8.1,263,86,178,0.327,367,0.717,23,0.765,4.9,311,110,200,0.354,455,0.684,29,0.73,5.4
277,201567,Kevin Love,1610612739,CLE,74,50,24,2493.0,141,85,52,0.603,320,0.441,5,0.448,7.3,585,238,343,0.407,938,0.624,71,0.675,4.2,726,323,395,0.445,1258,0.577,76,0.614,4.8
278,2755,Kevin Martin,1610612750,MIN,38,11,27,1280.0,18,6,11,0.333,94,0.191,4,0.2,14.3,119,12,104,0.101,191,0.623,23,0.708,8.2,137,18,115,0.131,285,0.481,27,0.531,9.0
279,202338,Kevin Seraphin,1610612764,WAS,79,45,34,1235.0,87,57,27,0.655,210,0.414,5,0.424,6.4,201,72,129,0.358,405,0.496,44,0.557,5.0,288,129,156,0.448,615,0.468,49,0.509,5.4
280,203114,Khris Middleton,1610612749,MIL,78,39,39,2345.0,48,26,20,0.542,176,0.273,9,0.287,11.6,293,70,224,0.239,460,0.637,32,0.685,7.0,341,96,244,0.282,636,0.536,41,0.573,7.6
281,2550,Kirk Hinrich,1610612741,CHI,66,37,29,1610.0,20,2,18,0.1,82,0.244,2,0.25,19.4,101,24,74,0.238,202,0.5,13,0.534,10.2,121,26,92,0.215,284,0.426,15,0.45,11.8
282,202691,Klay Thompson,1610612744,GSW,77,64,13,2455.0,27,14,13,0.519,175,0.154,10,0.164,10.7,220,53,169,0.241,430,0.512,36,0.558,8.3,247,67,182,0.271,605,0.408,46,0.442,8.6
283,977,Kobe Bryant,1610612747,LAL,35,10,25,1207.0,26,20,9,0.769,102,0.255,6,0.271,8.6,173,31,142,0.179,279,0.62,22,0.673,7.0,199,51,151,0.256,381,0.522,28,0.564,7.2
284,201585,Kosta Koufos,1610612763,MEM,81,55,26,1348.0,121,74,43,0.612,256,0.473,6,0.484,5.5,305,141,163,0.462,488,0.625,45,0.688,4.0,426,215,206,0.505,744,0.573,51,0.615,4.4
285,203123,Kostas Papanikolaou,1610612745,HOU,42,28,14,771.0,39,17,20,0.436,105,0.371,4,0.386,10.4,79,26,53,0.329,193,0.409,22,0.462,6.7,118,43,73,0.364,298,0.396,26,0.434,7.9
286,2743,Kris Humphries,1610612764,WAS,64,37,27,1345.0,118,75,41,0.636,304,0.388,8,0.399,6.0,298,95,201,0.319,500,0.596,39,0.646,4.7,416,170,242,0.409,804,0.517,47,0.55,5.1
287,203937,Kyle Anderson,1610612759,SAS,33,22,11,358.0,5,4,1,0.8,22,0.227,1,0.238,7.1,67,21,45,0.313,109,0.615,6,0.65,6.0,72,25,46,0.347,131,0.55,7,0.581,6.1
288,2594,Kyle Korver,1610612737,ATL,75,58,17,2418.0,15,4,12,0.267,102,0.147,4,0.153,22.0,289,88,197,0.304,575,0.503,43,0.543,6.9,304,92,209,0.303,677,0.449,47,0.483,7.7
289,200768,Kyle Lowry,1610612761,TOR,70,43,27,2414.0,54,32,23,0.593,268,0.201,13,0.212,10.1,274,51,225,0.186,549,0.499,47,0.546,8.5,328,83,248,0.253,817,0.401,60,0.433,8.9
290,203124,Kyle O'Quinn,1610612753,ORL,51,15,36,824.0,46,32,13,0.696,115,0.4,5,0.418,5.6,153,62,91,0.405,268,0.571,26,0.632,4.2,199,94,104,0.472,383,0.52,31,0.565,4.5
291,202713,Kyle Singler,1610612760,OKC,80,36,44,1744.0,33,13,20,0.394,147,0.224,1,0.226,12.9,161,43,117,0.267,346,0.465,31,0.511,7.2,194,56,137,0.289,493,0.394,32,0.421,8.2
292,202681,Kyrie Irving,1610612739,CLE,74,52,22,2687.0,55,20,39,0.364,253,0.217,13,0.229,13.5,178,32,148,0.18,404,0.441,24,0.468,10.6,233,52,187,0.223,657,0.355,37,0.376,11.4
293,200746,LaMarcus Aldridge,1610612757,POR,71,48,23,2512.0,177,120,46,0.678,344,0.515,15,0.538,6.4,549,186,364,0.339,797,0.689,50,0.735,4.9,726,306,410,0.421,1141,0.636,65,0.675,5.3
294,202362,Lance Stephenson,1610612766,CHA,61,23,38,1573.0,39,16,22,0.41,164,0.238,5,0.245,9.4,238,33,202,0.139,349,0.682,28,0.741,6.0,277,49,224,0.177,513,0.54,33,0.577,6.4
295,202498,Lance Thomas,1610612752,NYK,61,20,41,1473.0,65,30,31,0.462,185,0.351,7,0.365,9.0,126,25,101,0.198,230,0.548,16,0.589,8.5,191,55,132,0.288,415,0.46,23,0.487,8.6
296,202361,Landry Fields,1610612761,TOR,26,16,10,216.0,10,5,5,0.5,18,0.556,0,0.556,6.9,16,1,15,0.063,28,0.571,3,0.64,8.1,26,6,20,0.231,46,0.565,3,0.605,7.6
297,204038,Langston Galloway,1610612752,NYK,44,12,32,1429.0,37,15,23,0.405,112,0.33,8,0.356,13.8,152,24,130,0.158,257,0.591,23,0.65,9.1,189,39,153,0.206,369,0.512,31,0.559,10.0
298,203580,Larry Drew II,1610612755,PHI,12,4,8,219.0,1,0,2,0.0,11,0.091,0,0.091,8.5,14,0,15,0.0,29,0.483,5,0.583,9.2,15,0,17,0.0,40,0.375,5,0.429,9.3
299,202336,Larry Sanders,1610612749,MIL,27,12,15,586.0,67,46,18,0.687,142,0.472,4,0.486,4.3,99,49,48,0.495,191,0.518,15,0.563,4.3,166,95,66,0.572,333,0.498,19,0.529,4.3
300,202730,Lavoy Allen,1610612754,IND,63,29,34,1070.0,123,78,41,0.634,274,0.449,9,0.464,5.5,200,70,129,0.35,345,0.58,32,0.639,4.8,323,148,170,0.458,619,0.522,41,0.559,5.0
301,2544,LeBron James,1610612739,CLE,68,50,18,2453.0,51,27,23,0.529,214,0.238,4,0.243,9.7,361,78,283,0.216,530,0.681,13,0.698,7.5,412,105,306,0.255,744,0.554,17,0.567,7.7
302,2571,Leandro Barbosa,1610612744,GSW,66,54,12,982.0,23,10,13,0.435,80,0.288,3,0.299,12.1,68,13,55,0.191,121,0.562,10,0.613,10.5,91,23,68,0.253,201,0.453,13,0.484,10.9
303,201991,Lester Hudson,1610612746,LAC,5,5,0,56.0,1,0,1,0.0,6,0.167,0,0.167,7.4,7,4,3,0.571,11,0.636,1,0.7,9.1,8,4,4,0.5,17,0.471,1,0.5,8.9
304,203485,Lorenzo Brown,1610612750,MIN,29,6,23,549.0,14,5,9,0.357,47,0.298,4,0.326,11.8,56,12,44,0.214,96,0.583,6,0.622,7.1,70,17,53,0.243,143,0.49,10,0.526,8.1
305,200811,Lou Amundson,1610612752,NYK,52,17,35,920.0,93,61,30,0.656,235,0.396,6,0.406,5.1,169,64,103,0.379,340,0.497,34,0.552,4.2,262,125,133,0.477,575,0.456,40,0.49,4.5
306,101150,Lou Williams,1610612761,TOR,80,48,32,2016.0,24,12,12,0.5,123,0.195,6,0.205,14.0,127,13,114,0.102,230,0.552,18,0.599,9.9,151,25,126,0.166,353,0.428,24,0.459,10.5
307,201601,Luc Mbah a Moute,1610612755,PHI,67,16,51,1916.0,82,49,30,0.598,260,0.315,11,0.329,7.9,246,84,160,0.341,496,0.496,38,0.537,7.3,328,133,190,0.405,756,0.434,49,0.464,7.4
308,203512,Lucas Nogueira,1610612761,TOR,6,3,3,23.0,2,2,0,1.0,7,0.286,0,0.286,4.0,9,5,4,0.556,9,1.0,1,1.125,4.8,11,7,4,0.636,16,0.688,1,0.733,4.7
309,2449,Luis Scola,1610612754,IND,81,37,44,1659.0,138,91,39,0.659,367,0.376,10,0.387,5.9,388,137,248,0.353,602,0.645,56,0.711,4.3,526,228,287,0.433,969,0.543,66,0.583,4.7
310,202337,Luke Babbitt,1610612740,NOP,63,34,29,830.0,12,8,4,0.667,50,0.24,2,0.25,11.4,99,31,70,0.313,192,0.516,17,0.566,5.8,111,39,74,0.351,242,0.459,19,0.498,6.4
311,2557,Luke Ridnour,1610612753,ORL,47,13,34,683.0,8,3,4,0.375,30,0.267,0,0.267,8.0,60,9,51,0.15,102,0.588,7,0.632,9.8,68,12,55,0.176,132,0.515,7,0.544,9.6
312,2736,Luol Deng,1610612748,MIA,71,32,39,2381.0,100,61,37,0.61,277,0.361,9,0.373,7.4,268,66,203,0.246,491,0.546,50,0.608,7.7,368,127,240,0.345,768,0.479,59,0.519,7.6
313,202723,Malcolm Lee,1610612755,PHI,1,0,1,2.0,0,0,0,0.0,0,0.0,0,0.0,0.0,0,0,0,0.0,0,0.0,0,0.0,0.0,0,0,0,0.0,0,0.0,0,0.0,0.0
314,202952,Malcolm Thomas,1610612755,PHI,17,2,15,194.0,16,11,5,0.688,37,0.432,1,0.444,4.8,40,18,24,0.45,57,0.702,6,0.784,4.7,56,29,29,0.518,94,0.596,7,0.644,4.7
315,1938,Manu Ginobili,1610612759,SAS,70,47,23,1587.0,28,12,16,0.429,137,0.204,6,0.214,14.8,183,49,135,0.268,320,0.572,27,0.625,7.8,211,61,151,0.289,457,0.462,33,0.498,8.7
316,201188,Marc Gasol,1610612763,MEM,81,55,26,2687.0,115,90,23,0.783,280,0.411,11,0.428,6.0,515,247,262,0.48,857,0.601,57,0.644,5.0,630,337,285,0.535,1137,0.554,68,0.589,5.2
317,101162,Marcin Gortat,1610612764,WAS,82,46,36,2453.0,180,117,61,0.65,437,0.412,18,0.43,5.9,537,169,366,0.315,962,0.558,72,0.603,4.3,717,286,427,0.399,1399,0.513,90,0.548,4.7
318,201158,Marco Belinelli,1610612759,SAS,62,41,21,1388.0,26,6,19,0.231,72,0.361,3,0.377,15.1,131,20,111,0.153,228,0.575,12,0.606,8.0,157,26,130,0.166,300,0.523,15,0.551,9.1
319,202694,Marcus Morris,1610612756,PHX,81,39,42,2045.0,73,46,25,0.63,216,0.338,7,0.349,9.4,312,102,211,0.327,518,0.602,32,0.642,5.6,385,148,236,0.384,734,0.525,39,0.554,6.3
320,203935,Marcus Smart,1610612738,BOS,67,35,32,1808.0,61,31,26,0.508,169,0.361,6,0.374,10.3,161,42,119,0.261,312,0.516,26,0.563,8.2,222,73,145,0.329,481,0.462,32,0.494,8.7
321,201977,Marcus Thornton,1610612756,PHX,48,19,29,721.0,23,6,17,0.261,87,0.264,4,0.277,10.0,63,14,49,0.222,120,0.525,11,0.578,7.4,86,20,66,0.233,207,0.415,15,0.448,8.1
322,201596,Mario Chalmers,1610612748,MIA,79,35,44,2337.0,23,7,18,0.304,169,0.136,6,0.141,13.6,182,30,155,0.165,378,0.481,30,0.523,9.4,205,37,173,0.18,547,0.375,36,0.401,9.9
323,203900,Markel Brown,1610612751,BKN,47,23,24,781.0,16,7,9,0.438,69,0.232,4,0.246,12.6,91,15,76,0.165,140,0.65,8,0.689,7.6,107,22,85,0.206,209,0.512,12,0.543,8.3
324,202693,Markieff Morris,1610612756,PHX,82,39,43,2581.0,110,61,48,0.555,292,0.377,12,0.393,7.9,396,144,248,0.364,727,0.545,75,0.607,5.2,506,205,296,0.405,1019,0.497,87,0.543,5.8
325,201578,Marreese Speights,1610612744,GSW,76,62,14,1207.0,109,80,25,0.734,237,0.46,3,0.466,5.0,216,108,106,0.5,422,0.512,41,0.567,4.1,325,188,131,0.578,659,0.493,44,0.528,4.4
326,101110,Martell Webster,1610612764,WAS,32,12,20,352.0,10,5,5,0.5,25,0.4,0,0.4,8.6,36,7,28,0.194,58,0.621,5,0.679,6.1,46,12,33,0.261,83,0.554,5,0.59,6.6
327,101107,Marvin Williams,1610612766,CHA,78,32,46,2035.0,58,30,24,0.517,152,0.382,7,0.4,10.5,328,91,235,0.277,580,0.566,52,0.621,5.8,386,121,259,0.313,732,0.527,59,0.574,6.5
328,203486,Mason Plumlee,1610612751,BKN,82,38,44,1743.0,175,121,46,0.691,413,0.424,11,0.435,5.7,337,149,189,0.442,600,0.562,57,0.621,4.3,512,270,235,0.527,1013,0.505,68,0.542,4.7
329,2440,Matt Barnes,1610612746,LAC,76,51,25,2271.0,51,25,23,0.49,166,0.307,11,0.329,11.6,251,59,195,0.235,446,0.563,42,0.621,6.3,302,84,218,0.278,612,0.493,53,0.54,7.1
330,2588,Matt Bonner,1610612759,SAS,72,49,23,935.0,29,15,14,0.517,82,0.354,4,0.372,12.3,86,27,59,0.314,210,0.41,19,0.45,6.2,115,42,73,0.365,292,0.394,23,0.428,7.7
331,203521,Matthew Dellavedova,1610612739,CLE,66,43,23,1365.0,35,11,24,0.314,108,0.324,3,0.333,14.1,88,14,72,0.159,226,0.389,23,0.433,9.2,123,25,96,0.203,334,0.368,26,0.399,10.7
332,203090,Maurice Harkless,1610612753,ORL,45,9,36,674.0,38,22,14,0.579,87,0.437,4,0.458,5.4,68,20,48,0.294,130,0.523,14,0.586,7.6,106,42,62,0.396,217,0.488,18,0.533,6.8
333,203086,Meyers Leonard,1610612757,POR,55,32,23,847.0,46,26,21,0.565,129,0.357,4,0.368,8.4,204,69,135,0.338,315,0.648,28,0.711,4.8,250,95,156,0.38,444,0.563,32,0.607,5.5
334,201563,Michael Beasley,1610612748,MIA,24,11,13,505.0,12,5,5,0.417,40,0.3,1,0.308,6.0,77,30,47,0.39,137,0.562,10,0.606,5.7,89,35,52,0.393,177,0.503,11,0.536,5.7
335,203487,Michael Carter-Williams,1610612749,MIL,66,21,45,2150.0,64,36,27,0.563,233,0.275,8,0.284,11.0,289,64,227,0.221,499,0.579,31,0.618,7.3,353,100,254,0.283,732,0.482,39,0.509,8.0
336,203077,Michael Kidd-Gilchrist,1610612766,CHA,55,27,28,1587.0,109,62,46,0.569,297,0.367,10,0.38,8.1,307,89,215,0.29,502,0.612,48,0.676,5.2,416,151,261,0.363,799,0.521,58,0.561,6.0
337,201144,Mike Conley,1610612763,MEM,70,47,23,2225.0,29,8,21,0.276,130,0.223,7,0.236,14.0,180,24,159,0.133,353,0.51,33,0.563,9.6,209,32,180,0.153,483,0.433,40,0.472,10.1
338,2399,Mike Dunleavy,1610612741,CHI,63,41,22,1838.0,28,17,12,0.607,135,0.207,5,0.215,7.7,220,45,176,0.205,426,0.516,54,0.591,7.4,248,62,188,0.25,561,0.442,59,0.494,7.5
339,2034,Mike Miller,1610612739,CLE,51,31,20,675.0,4,1,3,0.25,28,0.143,2,0.154,18.1,87,16,71,0.184,146,0.596,10,0.64,6.9,91,17,74,0.187,174,0.523,12,0.562,7.4
340,203488,Mike Muscala,1610612737,ATL,40,26,14,502.0,52,31,20,0.596,103,0.505,1,0.51,7.2,67,27,39,0.403,169,0.396,17,0.441,3.7,119,58,59,0.487,272,0.438,18,0.469,5.2
341,203118,Mike Scott,1610612737,ATL,68,52,16,1123.0,45,29,16,0.644,102,0.441,3,0.455,6.9,154,58,96,0.377,275,0.56,20,0.604,5.9,199,87,112,0.437,377,0.528,23,0.562,6.1
342,203101,Miles Plumlee,1610612749,MIL,73,34,39,1194.0,112,77,32,0.688,248,0.452,8,0.467,6.2,208,85,121,0.409,428,0.486,43,0.54,3.8,320,162,153,0.506,676,0.473,51,0.512,4.6
343,203545,Miroslav Raduljica,1610612750,MIN,5,0,5,23.0,2,1,1,0.5,6,0.333,0,0.333,7.8,3,1,2,0.333,7,0.429,1,0.5,4.6,5,2,3,0.4,13,0.385,1,0.417,5.9
344,203141,Mirza Teletovic,1610612751,BKN,40,16,24,892.0,27,18,10,0.667,80,0.338,3,0.351,6.5,167,60,105,0.359,312,0.535,22,0.576,4.9,194,78,115,0.402,392,0.495,25,0.529,5.1
345,203956,Mitch McGary,1610612760,OKC,32,20,12,485.0,53,37,16,0.698,114,0.465,0,0.465,6.6,112,40,70,0.357,189,0.593,25,0.683,5.1,165,77,86,0.467,303,0.545,25,0.594,5.6
346,2590,Mo Williams,1610612766,CHA,67,20,47,1967.0,22,4,18,0.182,76,0.289,5,0.31,16.6,150,20,134,0.133,293,0.512,22,0.554,9.5,172,24,152,0.14,369,0.466,27,0.503,10.4
347,101145,Monta Ellis,1610612742,DAL,80,50,30,2699.0,34,13,20,0.382,185,0.184,9,0.193,11.9,156,26,131,0.167,336,0.464,19,0.492,9.4,190,39,151,0.205,521,0.365,28,0.385,9.8
348,101126,Nate Robinson,1610612743,DEN,42,22,20,591.0,17,3,13,0.176,56,0.304,1,0.309,17.6,33,4,30,0.121,67,0.493,2,0.508,14.4,50,7,43,0.14,123,0.407,3,0.417,15.5
349,203489,Nate Wolters,1610612749,MIL,21,14,7,247.0,8,5,3,0.625,21,0.381,1,0.4,15.1,26,5,22,0.192,47,0.553,3,0.591,8.2,34,10,25,0.294,68,0.5,4,0.531,9.8
350,1737,Nazr Mohammed,1610612741,CHI,23,13,10,128.0,11,8,3,0.727,18,0.611,1,0.647,6.3,27,13,12,0.481,40,0.675,2,0.711,4.3,38,21,15,0.553,58,0.655,3,0.691,4.9
351,2403,Nene,1610612764,WAS,67,37,30,1693.0,84,48,36,0.571,251,0.335,12,0.351,8.8,261,114,143,0.437,440,0.593,36,0.646,5.4,345,162,179,0.47,691,0.499,48,0.537,6.2
352,203457,Nerlens Noel,1610612755,PHI,75,18,57,2311.0,185,110,70,0.595,449,0.412,13,0.424,6.0,426,168,254,0.394,729,0.584,58,0.635,4.7,611,278,324,0.455,1178,0.519,71,0.552,5.1
353,201979,Nick Calathes,1610612763,MEM,58,36,22,838.0,19,12,7,0.632,68,0.279,1,0.284,7.1,87,20,67,0.23,169,0.515,17,0.572,8.3,106,32,74,0.302,237,0.447,18,0.484,8.1
354,2555,Nick Collison,1610612760,OKC,66,38,28,1101.0,90,62,27,0.689,204,0.441,6,0.455,5.8,160,74,84,0.463,312,0.513,28,0.563,5.5,250,136,111,0.544,516,0.484,34,0.519,5.6
355,203910,Nick Johnson,1610612745,HOU,27,17,10,258.0,13,7,6,0.538,36,0.361,0,0.361,7.1,26,9,16,0.346,55,0.473,5,0.52,7.9,39,16,22,0.41,91,0.429,5,0.453,7.6
356,201156,Nick Young,1610612747,LAL,42,12,30,1000.0,17,4,14,0.235,64,0.266,2,0.274,17.9,79,14,65,0.177,132,0.598,13,0.664,9.8,96,18,79,0.188,196,0.49,15,0.53,11.4
357,201587,Nicolas Batum,1610612757,POR,71,43,28,2380.0,62,31,31,0.5,201,0.308,5,0.316,10.4,354,63,289,0.178,590,0.6,50,0.656,5.7,416,94,320,0.226,791,0.526,55,0.565,6.4
358,203917,Nik Stauskas,1610612758,SAC,73,26,47,1127.0,11,2,10,0.182,66,0.167,2,0.172,16.1,77,14,62,0.182,153,0.503,10,0.538,9.4,88,16,72,0.182,219,0.402,12,0.425,10.3
359,202703,Nikola Mirotic,1610612741,CHI,82,50,32,1654.0,63,39,22,0.619,197,0.32,6,0.33,7.4,341,128,211,0.375,549,0.621,40,0.67,4.7,404,167,233,0.413,746,0.542,46,0.577,5.1
360,201593,Nikola Pekovic,1610612750,MIN,30,9,21,787.0,85,65,18,0.765,209,0.407,8,0.423,5.1,136,61,75,0.449,227,0.599,22,0.663,4.4,221,126,93,0.57,436,0.507,30,0.544,4.7
361,202696,Nikola Vucevic,1610612753,ORL,74,21,53,2529.0,238,158,74,0.664,416,0.572,3,0.576,5.1,572,237,330,0.414,807,0.709,58,0.764,4.2,810,395,404,0.488,1223,0.662,61,0.697,4.5
362,203943,Noah Vonleh,1610612766,CHA,25,8,17,259.0,28,21,8,0.75,69,0.406,1,0.412,4.6,58,16,41,0.276,90,0.644,9,0.716,3.9,86,37,49,0.43,159,0.541,10,0.577,4.1
363,202708,Norris Cole,1610612740,NOP,74,36,38,1797.0,12,3,8,0.25,94,0.128,9,0.141,18.8,145,18,130,0.124,301,0.482,22,0.52,10.8,157,21,138,0.134,395,0.397,31,0.431,11.3
364,201564,O.J. Mayo,1610612749,MIL,70,38,32,1673.0,30,12,19,0.4,119,0.252,7,0.268,14.0,156,34,118,0.218,310,0.503,27,0.551,8.7,186,46,137,0.247,429,0.434,34,0.471,9.6
365,203136,Ognjen Kuzmic,1610612744,GSW,16,13,3,72.0,7,7,0,1.0,14,0.5,1,0.538,7.5,10,5,7,0.5,27,0.37,4,0.435,4.1,17,12,7,0.706,41,0.415,5,0.472,5.4
366,201600,Omer Asik,1610612740,NOP,76,43,33,1982.0,244,182,56,0.746,562,0.434,14,0.445,4.4,504,213,286,0.423,802,0.628,67,0.686,3.9,748,395,342,0.528,1364,0.548,81,0.583,4.1
367,201956,Omri Casspi,1610612758,SAC,67,23,44,1416.0,54,34,18,0.63,208,0.26,6,0.267,7.0,206,36,172,0.175,359,0.574,35,0.636,6.4,260,70,190,0.269,567,0.459,41,0.494,6.5
368,203490,Otto Porter Jr.,1610612764,WAS,74,41,33,1432.0,70,34,36,0.486,174,0.402,9,0.424,8.8,151,30,120,0.199,286,0.528,23,0.574,6.8,221,64,156,0.29,460,0.48,32,0.516,7.5
369,203798,PJ Hairston,1610612766,CHA,45,19,26,687.0,22,11,11,0.5,73,0.301,1,0.306,13.1,70,13,56,0.186,117,0.598,13,0.673,6.6,92,24,67,0.261,190,0.484,14,0.523,8.2
370,200782,PJ Tucker,1610612756,PHX,78,36,42,2383.0,114,79,32,0.693,281,0.406,12,0.424,7.0,388,111,273,0.286,613,0.633,47,0.686,5.6,502,190,305,0.378,894,0.562,59,0.601,5.9
371,203143,Pablo Prigioni,1610612745,HOU,66,25,41,1192.0,30,11,21,0.367,90,0.333,7,0.361,13.7,89,7,84,0.079,178,0.5,6,0.517,10.8,119,18,105,0.151,268,0.444,13,0.467,11.6
372,201976,Patrick Beverley,1610612745,HOU,56,35,21,1727.0,67,35,32,0.522,207,0.324,3,0.328,11.6,170,37,130,0.218,331,0.514,37,0.578,8.7,237,72,162,0.304,538,0.441,40,0.476,9.5
373,203565,Patrick Christopher,1610612763,MEM,4,2,2,29.0,2,1,1,0.5,5,0.4,1,0.5,11.8,4,1,3,0.25,7,0.571,0,0.571,5.6,6,2,4,0.333,12,0.5,1,0.545,7.7
374,202335,Patrick Patterson,1610612761,TOR,81,49,32,2156.0,127,68,58,0.535,241,0.527,2,0.531,8.7,306,118,187,0.386,553,0.553,46,0.604,5.0,433,186,245,0.43,794,0.545,48,0.58,6.1
375,201988,Patty Mills,1610612759,SAS,51,37,14,801.0,21,7,14,0.333,65,0.323,0,0.323,15.2,54,12,43,0.222,137,0.394,11,0.429,10.8,75,19,57,0.253,202,0.371,11,0.393,12.0
376,2200,Pau Gasol,1610612741,CHI,78,48,30,2681.0,220,127,86,0.577,465,0.473,11,0.485,7.0,699,272,423,0.389,1163,0.601,90,0.651,4.4,919,399,509,0.434,1628,0.564,101,0.602,5.0
377,202331,Paul George,1610612754,IND,6,5,1,91.0,4,4,0,1.0,8,0.5,0,0.5,5.3,18,2,16,0.111,26,0.692,1,0.72,6.9,22,6,16,0.273,34,0.647,1,0.667,6.6
378,200794,Paul Millsap,1610612737,ATL,73,55,18,2390.0,139,105,32,0.755,366,0.38,8,0.388,5.4,431,187,240,0.434,752,0.573,35,0.601,4.8,570,292,272,0.512,1118,0.51,43,0.53,4.9
379,1718,Paul Pierce,1610612764,WAS,73,40,33,1914.0,45,26,15,0.578,125,0.36,8,0.385,9.2,249,46,204,0.185,424,0.587,28,0.629,7.2,294,72,219,0.245,549,0.536,36,0.573,7.5
380,203544,Pero Antic,1610612737,ATL,63,46,17,1037.0,58,41,17,0.707,157,0.369,3,0.377,5.0,131,56,75,0.427,275,0.476,21,0.516,5.9,189,97,92,0.513,432,0.438,24,0.463,5.6
381,203103,Perry Jones III,1610612760,OKC,43,23,20,631.0,6,3,3,0.5,41,0.146,3,0.158,7.7,70,16,54,0.229,112,0.625,7,0.667,7.4,76,19,57,0.25,153,0.497,10,0.531,7.4
382,203515,Phil Pressey,1610612738,BOS,50,22,28,600.0,13,3,9,0.231,63,0.206,0,0.206,17.2,67,10,56,0.149,126,0.532,9,0.573,9.5,80,13,65,0.163,189,0.423,9,0.444,10.7
383,203112,Quincy Acy,1610612752,NYK,67,12,55,1283.0,79,46,29,0.582,226,0.35,10,0.366,7.4,222,64,158,0.288,366,0.607,27,0.655,5.1,301,110,187,0.365,592,0.508,37,0.542,5.7
384,203113,Quincy Miller,1610612765,DET,10,2,8,120.0,4,1,3,0.25,26,0.154,3,0.174,7.7,16,2,14,0.125,38,0.421,4,0.471,5.0,20,3,17,0.15,64,0.313,7,0.351,5.5
385,202347,Quincy Pondexter,1610612740,NOP,75,48,27,1793.0,53,29,26,0.547,178,0.298,8,0.312,11.0,142,28,111,0.197,273,0.52,25,0.573,8.9,195,57,137,0.292,451,0.432,33,0.467,9.5
386,200765,Rajon Rondo,1610612742,DAL,68,34,34,2019.0,73,34,37,0.466,220,0.332,3,0.336,9.5,300,44,256,0.147,501,0.599,39,0.649,7.2,373,78,293,0.209,721,0.517,42,0.549,7.7
387,201196,Ramon Sessions,1610612764,WAS,64,26,38,1188.0,23,7,15,0.304,79,0.291,4,0.307,13.3,121,16,104,0.132,205,0.59,6,0.608,9.6,144,23,119,0.16,284,0.507,10,0.526,10.2
388,200751,Randy Foye,1610612743,DEN,50,15,35,1086.0,9,1,8,0.111,57,0.158,3,0.167,19.4,76,7,71,0.092,161,0.472,14,0.517,11.0,85,8,79,0.094,218,0.39,17,0.423,11.9
389,2446,Rasual Butler,1610612764,WAS,75,39,36,1505.0,27,12,15,0.444,76,0.355,6,0.386,15.1,170,38,133,0.224,284,0.599,20,0.644,7.5,197,50,148,0.254,360,0.547,26,0.59,8.6
390,203492,Ray McCallum,1610612758,SAC,68,22,46,1436.0,52,24,23,0.462,144,0.361,7,0.38,11.4,128,23,106,0.18,234,0.547,10,0.571,9.7,180,47,129,0.261,378,0.476,17,0.499,10.2
391,101109,Raymond Felton,1610612742,DAL,29,14,15,281.0,2,0,2,0.0,15,0.133,1,0.143,19.7,24,3,21,0.125,47,0.511,2,0.533,11.9,26,3,23,0.115,62,0.419,3,0.441,12.5
392,203493,Reggie Bullock,1610612756,PHX,36,19,17,338.0,1,1,0,1.0,12,0.083,0,0.083,5.7,49,10,41,0.204,81,0.605,8,0.671,7.3,50,11,41,0.22,93,0.538,8,0.588,7.3
393,2501,Reggie Evans,1610612758,SAC,47,16,31,764.0,97,71,25,0.732,255,0.38,11,0.398,5.4,202,69,130,0.342,332,0.608,22,0.652,4.5,299,140,155,0.468,587,0.509,33,0.54,4.8
394,202704,Reggie Jackson,1610612765,DET,77,37,40,2268.0,56,14,40,0.25,193,0.29,15,0.315,12.1,271,38,234,0.14,467,0.58,40,0.635,8.4,327,52,274,0.159,660,0.495,55,0.54,9.1
395,202130,Reggie Williams,1610612759,SAS,20,15,5,105.0,5,3,2,0.6,10,0.5,1,0.556,12.6,12,3,9,0.25,21,0.571,1,0.6,5.7,17,6,11,0.353,31,0.548,2,0.586,7.7
396,2210,Richard Jefferson,1610612742,DAL,74,46,28,1244.0,25,10,13,0.4,106,0.236,4,0.245,11.9,158,42,119,0.266,283,0.558,23,0.608,6.8,183,52,132,0.284,389,0.47,27,0.506,7.4
397,203495,Ricky Ledo,1610612752,NYK,17,4,13,244.0,16,9,8,0.563,45,0.356,2,0.372,8.6,20,2,19,0.1,34,0.588,1,0.606,6.0,36,11,27,0.306,79,0.456,3,0.474,7.1
398,201937,Ricky Rubio,1610612750,MIN,22,7,15,692.0,19,9,9,0.474,53,0.358,3,0.38,12.5,106,18,89,0.17,168,0.631,13,0.684,7.4,125,27,98,0.216,221,0.566,16,0.61,8.1
399,203133,Robbie Hummel,1610612750,MIN,44,5,39,733.0,31,18,12,0.581,95,0.326,3,0.337,7.6,103,34,70,0.33,189,0.545,17,0.599,5.3,134,52,82,0.388,284,0.472,20,0.508,5.8
400,203496,Robert Covington,1610612755,PHI,70,18,52,1956.0,65,42,23,0.646,216,0.301,10,0.316,8.1,251,81,168,0.323,472,0.532,42,0.584,6.1,316,123,191,0.389,688,0.459,52,0.497,6.5
401,203135,Robert Sacre,1610612747,LAL,67,19,48,1133.0,89,56,32,0.629,212,0.42,8,0.436,6.6,144,46,97,0.319,310,0.465,33,0.52,6.0,233,102,129,0.438,522,0.446,41,0.484,6.2
402,201577,Robin Lopez,1610612757,POR,59,38,21,1638.0,190,146,35,0.768,455,0.418,12,0.429,4.6,204,96,109,0.471,484,0.421,61,0.482,5.1,394,242,144,0.614,939,0.42,73,0.455,4.9
403,203918,Rodney Hood,1610612762,UTA,50,27,23,1064.0,9,1,8,0.111,56,0.161,4,0.173,15.8,108,21,86,0.194,213,0.507,13,0.54,6.6,117,22,94,0.188,269,0.435,17,0.464,7.3
404,201155,Rodney Stuckey,1610612754,IND,71,34,37,1874.0,36,14,22,0.389,147,0.245,4,0.252,15.0,212,28,180,0.132,339,0.625,25,0.675,8.2,248,42,202,0.169,486,0.51,29,0.543,9.2
405,101179,Ronnie Price,1610612747,LAL,43,13,30,982.0,19,3,14,0.158,65,0.292,3,0.306,16.4,50,11,40,0.22,128,0.391,9,0.42,11.4,69,14,54,0.203,193,0.358,12,0.381,12.6
406,101142,Ronny Turiaf,1610612750,MIN,1,0,1,10.0,0,0,0,0.0,1,0.0,0,0.0,0.0,0,0,0,0.0,0,0.0,0,0.0,0.0,0,0,0,0.0,1,0.0,0,0.0,0.0
407,201579,Roy Hibbert,1610612754,IND,76,34,42,1926.0,156,106,44,0.679,360,0.433,4,0.438,5.5,384,125,255,0.326,686,0.56,64,0.617,4.8,540,231,299,0.428,1046,0.516,68,0.552,5.0
408,200752,Rudy Gay,1610612758,SAC,68,25,43,2408.0,98,59,35,0.602,297,0.33,8,0.339,8.0,301,74,223,0.246,500,0.602,28,0.638,6.8,399,133,258,0.333,797,0.501,36,0.524,7.1
409,203497,Rudy Gobert,1610612762,UTA,82,38,44,2158.0,265,193,63,0.728,531,0.499,10,0.509,5.4,510,200,307,0.392,865,0.59,77,0.647,3.8,775,393,370,0.507,1396,0.555,87,0.592,4.3
410,203893,Russ Smith,1610612763,MEM,12,7,5,65.0,1,0,1,0.0,4,0.25,0,0.25,13.9,5,2,3,0.4,9,0.556,0,0.556,7.3,6,2,4,0.333,13,0.462,0,0.462,8.4
411,201566,Russell Westbrook,1610612760,OKC,67,40,27,2302.0,124,60,57,0.484,394,0.315,11,0.324,10.0,364,86,282,0.236,530,0.687,22,0.717,8.4,488,146,339,0.299,924,0.528,33,0.548,8.8
412,201583,Ryan Anderson,1610612740,NOP,61,33,28,1675.0,108,82,24,0.759,247,0.437,10,0.456,5.5,187,93,91,0.497,335,0.558,31,0.615,5.6,295,175,115,0.593,582,0.507,41,0.545,5.5
413,200797,Ryan Hollins,1610612758,SAC,46,13,33,441.0,36,23,9,0.639,88,0.409,0,0.409,4.8,67,23,43,0.343,159,0.421,18,0.475,4.5,103,46,52,0.447,247,0.417,18,0.45,4.6
414,203527,Ryan Kelly,1610612747,LAL,52,11,41,1233.0,13,5,8,0.385,74,0.176,2,0.181,9.4,133,29,102,0.218,225,0.591,18,0.643,7.0,146,34,110,0.233,299,0.488,20,0.523,7.3
415,2223,Samuel Dalembert,1610612752,NYK,32,5,27,544.0,53,38,13,0.717,107,0.495,1,0.5,6.9,115,54,60,0.47,215,0.535,18,0.584,3.3,168,92,73,0.548,322,0.522,19,0.554,4.4
416,203930,Sean Kilpatrick,1610612750,MIN,4,2,2,72.0,1,1,0,1.0,3,0.333,0,0.333,1.4,5,1,4,0.2,13,0.385,0,0.385,6.4,6,2,4,0.333,16,0.375,0,0.375,5.6
417,2742,Sebastian Telfair,1610612760,OKC,16,4,12,327.0,2,1,1,0.5,15,0.133,0,0.133,4.3,28,0,28,0.0,38,0.737,0,0.737,12.1,30,1,29,0.033,53,0.566,0,0.566,11.6
418,201586,Serge Ibaka,1610612760,OKC,64,35,29,2116.0,135,82,48,0.607,316,0.427,16,0.45,6.5,364,138,224,0.379,717,0.508,70,0.563,4.0,499,220,272,0.441,1033,0.483,86,0.527,4.7
419,203508,Sergey Karasev,1610612751,BKN,33,12,21,555.0,22,7,16,0.318,59,0.373,0,0.373,10.1,44,7,37,0.159,91,0.484,12,0.557,6.7,66,14,53,0.212,150,0.44,12,0.478,8.1
420,203552,Seth Curry,1610612756,PHX,2,2,0,8.0,0,0,0,0.0,1,0.0,0,0.0,0.0,2,0,2,0.0,3,0.667,0,0.667,6.0,2,0,2,0.0,4,0.5,0,0.5,6.0
421,203498,Shabazz Muhammad,1610612750,MIN,37,6,31,851.0,62,42,14,0.677,170,0.365,5,0.376,6.4,91,33,59,0.363,145,0.628,10,0.674,5.9,153,75,73,0.49,315,0.486,15,0.51,6.1
422,203894,Shabazz Napier,1610612748,MIA,51,24,27,1012.0,17,8,9,0.471,76,0.224,2,0.23,12.2,96,11,86,0.115,195,0.492,24,0.561,9.8,113,19,95,0.168,271,0.417,26,0.461,10.1
423,203499,Shane Larkin,1610612752,NYK,75,16,59,1845.0,29,7,22,0.241,96,0.302,2,0.309,18.1,146,24,126,0.164,317,0.461,43,0.533,8.6,175,31,148,0.177,413,0.424,45,0.476,10.2
424,200769,Shannon Brown,1610612748,MIA,5,3,2,89.0,0,0,0,0.0,9,0.0,0,0.0,0.0,1,1,1,1.0,9,0.111,2,0.143,8.3,1,1,1,1.0,18,0.056,2,0.063,8.3
425,2733,Shaun Livingston,1610612744,GSW,78,64,14,1468.0,43,19,24,0.442,139,0.309,5,0.321,8.5,140,32,110,0.229,286,0.49,12,0.511,9.4,183,51,134,0.279,425,0.431,17,0.449,9.3
426,101183,Shavlik Randolph,1610612756,PHX,21,11,10,126.0,16,13,3,0.813,45,0.356,1,0.364,3.9,22,11,10,0.5,48,0.458,8,0.55,3.7,38,24,13,0.632,93,0.409,9,0.452,3.8
427,1890,Shawn Marion,1610612739,CLE,56,36,20,1082.0,61,38,19,0.623,158,0.386,7,0.404,6.7,136,34,101,0.25,226,0.602,14,0.642,6.3,197,72,120,0.365,384,0.513,21,0.543,6.4
428,200761,Shawne Williams,1610612765,DET,62,25,37,1060.0,34,13,19,0.382,90,0.378,5,0.4,9.9,127,41,81,0.323,265,0.479,19,0.516,5.4,161,54,100,0.335,355,0.454,24,0.486,6.3
429,203963,Shayne Whittington,1610612754,IND,20,9,11,108.0,10,7,3,0.7,25,0.4,0,0.4,5.8,19,5,14,0.263,35,0.543,2,0.576,3.7,29,12,17,0.414,60,0.483,2,0.5,4.4
430,202714,Shelvin Mack,1610612737,ATL,55,37,18,833.0,8,2,6,0.25,62,0.129,2,0.133,12.3,71,11,60,0.155,141,0.504,5,0.522,8.5,79,13,66,0.165,203,0.389,7,0.403,8.9
431,204021,Sim Bhullar,1610612758,SAC,3,1,2,3.0,0,0,0,0.0,1,0.0,0,0.0,0.0,1,0,1,0.0,1,1.0,0,1.0,5.6,1,0,1,0.0,2,0.5,0,0.5,5.6
432,203524,Solomon Hill,1610612754,IND,82,38,44,2381.0,70,44,26,0.629,242,0.289,13,0.306,8.3,244,59,181,0.242,453,0.539,36,0.585,7.7,314,103,207,0.328,695,0.452,49,0.486,7.8
433,203915,Spencer Dinwiddie,1610612765,DET,34,12,22,455.0,4,3,1,0.75,28,0.143,0,0.143,10.2,44,6,38,0.136,71,0.62,4,0.657,10.0,48,9,39,0.188,99,0.485,4,0.505,10.0
434,201150,Spencer Hawes,1610612746,LAC,73,52,21,1274.0,30,20,11,0.667,113,0.265,2,0.27,7.1,228,82,146,0.36,443,0.515,50,0.58,4.7,258,102,157,0.395,556,0.464,52,0.512,5.0
435,201939,Stephen Curry,1610612744,GSW,80,67,13,2613.0,56,22,36,0.393,269,0.208,9,0.215,11.9,285,57,230,0.2,567,0.503,33,0.534,9.4,341,79,266,0.232,836,0.408,42,0.429,9.8
436,2581,Steve Blake,1610612757,POR,81,51,30,1529.0,16,5,11,0.313,57,0.281,0,0.281,17.0,121,10,112,0.083,285,0.425,28,0.471,10.5,137,15,123,0.109,342,0.401,28,0.436,11.2
437,200779,Steve Novak,1610612760,OKC,35,12,23,197.0,2,0,2,0.0,7,0.286,0,0.286,22.4,20,5,14,0.25,44,0.455,4,0.5,5.9,22,5,16,0.227,51,0.431,4,0.468,7.5
438,203500,Steven Adams,1610612760,OKC,70,37,33,1771.0,199,146,47,0.734,495,0.402,15,0.415,5.2,324,120,200,0.37,551,0.588,47,0.643,4.2,523,266,247,0.509,1046,0.5,62,0.532,4.6
439,203933,T.J. Warren,1610612756,PHX,40,17,23,614.0,41,26,15,0.634,103,0.398,2,0.406,6.7,44,15,29,0.341,96,0.458,3,0.473,7.2,85,41,44,0.482,199,0.427,5,0.438,7.0
440,201959,Taj Gibson,1610612741,CHI,62,38,24,1692.0,162,122,36,0.753,377,0.43,16,0.449,5.5,234,88,143,0.376,461,0.508,44,0.561,6.0,396,210,179,0.53,838,0.473,60,0.509,5.8
441,204028,Tarik Black,1610612747,LAL,62,24,38,1178.0,138,89,47,0.645,292,0.473,3,0.478,5.7,224,87,136,0.388,405,0.553,39,0.612,4.8,362,176,183,0.486,697,0.519,42,0.553,5.1
442,2419,Tayshaun Prince,1610612765,DET,58,27,31,1397.0,52,25,27,0.481,124,0.419,5,0.437,8.9,158,49,105,0.31,261,0.605,23,0.664,7.1,210,74,132,0.352,385,0.545,28,0.588,7.6
443,203093,Terrence Jones,1610612745,HOU,33,24,9,889.0,78,53,21,0.679,167,0.467,4,0.479,6.1,142,50,90,0.352,267,0.532,16,0.566,5.9,220,103,111,0.468,434,0.507,20,0.531,5.9
444,203082,Terrence Ross,1610612761,TOR,82,49,33,2092.0,32,6,26,0.188,94,0.34,5,0.36,17.7,194,43,149,0.222,360,0.539,18,0.567,7.0,226,49,175,0.217,454,0.498,23,0.524,8.5
445,200757,Thabo Sefolosha,1610612737,ATL,52,43,9,976.0,53,25,28,0.472,134,0.396,5,0.411,10.0,170,30,138,0.176,247,0.688,23,0.759,6.9,223,55,166,0.247,381,0.585,28,0.632,7.6
446,201152,Thaddeus Young,1610612751,BKN,75,25,50,2407.0,126,82,41,0.651,337,0.374,13,0.389,8.0,282,87,197,0.309,536,0.526,35,0.563,7.2,408,169,238,0.414,873,0.467,48,0.495,7.4
447,203080,Thomas Robinson,1610612755,PHI,54,26,28,798.0,95,69,28,0.726,257,0.37,10,0.385,5.6,208,94,114,0.452,313,0.665,24,0.72,4.8,303,163,142,0.538,570,0.532,34,0.565,5.1
448,201168,Tiago Splitter,1610612759,SAS,52,34,18,1030.0,91,64,24,0.703,210,0.433,5,0.444,5.2,161,68,94,0.422,300,0.537,35,0.608,4.8,252,132,118,0.524,510,0.494,40,0.536,4.9
449,1495,Tim Duncan,1610612759,SAS,77,53,24,2227.0,170,110,56,0.647,389,0.437,17,0.457,7.0,534,234,292,0.438,884,0.604,69,0.655,4.2,704,344,348,0.489,1273,0.553,86,0.593,4.9
450,204025,Tim Frazier,1610612757,POR,11,3,8,239.0,6,1,5,0.167,27,0.222,0,0.222,12.6,22,6,16,0.273,57,0.386,13,0.5,7.1,28,7,21,0.25,84,0.333,13,0.394,8.3
451,203501,Tim Hardaway Jr.,1610612752,NYK,69,16,53,1656.0,12,5,7,0.417,95,0.126,3,0.13,15.6,140,38,104,0.271,254,0.551,15,0.586,9.4,152,43,111,0.283,349,0.436,18,0.459,9.9
452,202389,Timofey Mozgov,1610612739,CLE,81,49,32,2046.0,203,133,65,0.655,500,0.406,14,0.418,5.5,388,192,195,0.495,716,0.542,69,0.6,4.0,591,325,260,0.55,1216,0.486,83,0.522,4.5
453,202699,Tobias Harris,1610612753,ORL,68,20,48,2369.0,73,42,28,0.575,231,0.316,6,0.324,8.7,357,91,266,0.255,523,0.683,33,0.729,6.1,430,133,294,0.309,754,0.57,39,0.601,6.5
454,201962,Toney Douglas,1610612740,NOP,12,7,5,177.0,2,1,1,0.5,13,0.154,0,0.154,10.8,20,2,18,0.1,35,0.571,3,0.625,8.3,22,3,19,0.136,48,0.458,3,0.489,8.5
455,2754,Tony Allen,1610612763,MEM,63,46,17,1648.0,103,72,29,0.699,323,0.319,10,0.329,5.2,177,41,136,0.232,272,0.651,16,0.691,7.3,280,113,165,0.404,595,0.471,26,0.492,6.5
456,2225,Tony Parker,1610612759,SAS,68,48,20,1953.0,15,6,11,0.4,143,0.105,7,0.11,17.4,114,14,100,0.123,237,0.481,17,0.518,10.5,129,20,111,0.155,380,0.339,24,0.362,11.3
457,203503,Tony Snell,1610612741,CHI,72,43,29,1412.0,31,9,22,0.29,98,0.316,5,0.333,13.1,145,35,112,0.241,265,0.547,20,0.592,8.0,176,44,134,0.25,363,0.485,25,0.521,8.9
458,203100,Tony Wroten,1610612755,PHI,30,4,26,895.0,22,16,8,0.727,111,0.198,4,0.206,9.3,64,12,52,0.188,133,0.481,10,0.52,7.9,86,28,60,0.326,244,0.352,14,0.374,8.3
459,203315,Toure' Murry,1610612762,UTA,5,3,2,18.0,1,0,1,0.0,2,0.5,0,0.5,9.0,0,0,0,0.0,3,0.0,1,0.0,0.0,1,0,1,0.0,5,0.2,1,0.25,9.0
460,204037,Travis Wear,1610612752,NYK,50,7,43,651.0,30,17,13,0.567,95,0.316,5,0.333,8.2,72,16,55,0.222,160,0.45,17,0.503,6.2,102,33,68,0.324,255,0.4,22,0.438,6.8
461,2772,Trevor Ariza,1610612745,HOU,81,55,26,2896.0,76,35,36,0.461,303,0.251,15,0.264,11.8,378,90,286,0.238,617,0.613,53,0.67,5.9,454,125,322,0.275,920,0.493,68,0.533,6.8
462,202344,Trevor Booker,1610612762,UTA,79,37,42,1564.0,139,76,61,0.547,298,0.466,12,0.486,7.4,258,91,164,0.353,432,0.597,35,0.65,5.0,397,167,225,0.421,730,0.544,47,0.581,5.8
463,203504,Trey Burke,1610612762,UTA,76,35,41,2288.0,31,6,29,0.194,143,0.217,5,0.225,15.0,173,22,155,0.127,338,0.512,21,0.546,11.2,204,28,184,0.137,481,0.424,26,0.448,12.0
464,202684,Tristan Thompson,1610612739,CLE,81,53,28,2168.0,270,203,58,0.752,673,0.401,22,0.415,4.8,378,134,243,0.354,665,0.568,54,0.619,5.0,648,337,301,0.52,1338,0.484,76,0.513,4.9
465,203584,Troy Daniels,1610612766,CHA,46,14,32,392.0,8,3,5,0.375,28,0.286,1,0.296,12.0,25,5,22,0.2,61,0.41,10,0.49,5.9,33,8,27,0.242,89,0.371,11,0.423,7.3
466,201951,Ty Lawson,1610612743,DEN,75,29,46,2665.0,42,7,35,0.167,184,0.228,11,0.243,18.8,192,24,171,0.125,341,0.563,22,0.602,11.4,234,31,206,0.132,525,0.446,33,0.476,12.7
467,203898,Tyler Ennis,1610612749,MIL,33,11,22,411.0,7,3,4,0.429,21,0.333,0,0.333,7.6,28,6,23,0.214,58,0.483,5,0.528,7.4,35,9,27,0.257,79,0.443,5,0.473,7.4
468,201946,Tyler Hansbrough,1610612761,TOR,74,45,29,1058.0,106,78,26,0.736,240,0.442,10,0.461,5.7,159,64,93,0.403,291,0.546,14,0.574,5.5,265,142,119,0.536,531,0.499,24,0.523,5.6
469,204020,Tyler Johnson,1610612748,MIA,32,15,17,603.0,14,12,2,0.857,61,0.23,2,0.237,7.1,67,19,48,0.284,130,0.515,9,0.554,9.2,81,31,50,0.383,191,0.424,11,0.45,8.8
470,203092,Tyler Zeller,1610612738,BOS,82,40,42,1731.0,146,103,43,0.705,400,0.365,11,0.375,5.6,319,146,174,0.458,596,0.535,58,0.593,5.1,465,249,217,0.535,996,0.467,69,0.502,5.3
471,201936,Tyreke Evans,1610612740,NOP,79,43,36,2690.0,82,51,29,0.622,340,0.241,15,0.252,8.8,334,67,266,0.201,562,0.594,40,0.64,7.3,416,118,295,0.284,902,0.461,55,0.491,7.6
472,200748,Tyrus Thomas,1610612763,MEM,2,2,0,7.0,0,0,0,0.0,0,0.0,0,0.0,0.0,0,0,0,0.0,0,0.0,0,0.0,0.0,0,0,0,0.0,0,0.0,0,0.0,0.0
473,2199,Tyson Chandler,1610612742,DAL,75,47,28,2286.0,294,211,76,0.718,549,0.536,9,0.544,5.3,570,216,345,0.379,957,0.596,71,0.643,4.2,864,427,421,0.494,1506,0.574,80,0.606,4.6
474,2617,Udonis Haslem,1610612748,MIA,61,30,31,982.0,70,47,25,0.671,203,0.345,6,0.355,6.4,184,73,110,0.397,336,0.548,33,0.607,4.5,254,120,135,0.472,539,0.471,39,0.508,5.0
475,203505,Vander Blue,1610612747,LAL,2,0,2,74.0,2,0,2,0.0,7,0.286,0,0.286,3.3,7,1,6,0.143,13,0.538,0,0.538,9.2,9,1,8,0.111,20,0.45,0,0.45,7.9
476,201964,Victor Claver,1610612757,POR,10,6,4,76.0,3,3,0,1.0,4,0.75,0,0.75,5.6,17,13,4,0.765,26,0.654,2,0.708,5.2,20,16,4,0.8,30,0.667,2,0.714,5.2
477,203506,Victor Oladipo,1610612753,ORL,72,22,50,2573.0,51,24,27,0.471,257,0.198,19,0.214,9.7,251,62,188,0.247,480,0.523,40,0.57,7.4,302,86,215,0.285,737,0.41,59,0.445,7.8
478,1713,Vince Carter,1610612763,MEM,66,45,21,1091.0,27,17,10,0.63,91,0.297,2,0.303,7.7,106,28,77,0.264,220,0.482,26,0.546,6.9,133,45,87,0.338,311,0.428,28,0.47,7.0
479,201961,Wayne Ellington,1610612747,LAL,65,18,47,1675.0,31,11,19,0.355,121,0.256,1,0.258,14.6,179,30,149,0.168,296,0.605,22,0.653,8.2,210,41,168,0.195,417,0.504,23,0.533,9.2
480,202325,Wesley Johnson,1610612747,LAL,76,20,56,2245.0,67,30,35,0.448,211,0.318,6,0.327,9.8,252,53,192,0.21,419,0.601,35,0.656,6.8,319,83,227,0.26,630,0.506,41,0.542,7.5
481,202083,Wesley Matthews,1610612757,POR,60,41,19,2024.0,38,13,25,0.342,126,0.302,5,0.314,14.1,184,38,147,0.207,356,0.517,37,0.577,7.5,222,51,172,0.23,482,0.461,42,0.505,8.6
482,203115,Will Barton,1610612743,DEN,58,30,28,984.0,26,14,12,0.538,108,0.241,1,0.243,13.1,136,22,114,0.162,224,0.607,20,0.667,5.8,162,36,126,0.222,332,0.488,21,0.521,7.0
483,101198,Will Bynum,1610612764,WAS,7,4,3,67.0,2,0,2,0.0,5,0.4,1,0.5,19.8,4,0,4,0.0,7,0.571,0,0.571,8.4,6,0,6,0.0,12,0.5,1,0.545,12.2
484,203805,Will Cherry,1610612761,TOR,8,6,2,69.0,1,1,0,1.0,5,0.2,0,0.2,3.8,4,1,3,0.25,13,0.308,1,0.333,10.8,5,2,3,0.4,18,0.278,1,0.294,9.4
485,2584,Willie Green,1610612753,ORL,52,15,37,951.0,14,6,7,0.429,53,0.264,4,0.286,13.3,65,14,51,0.215,137,0.474,15,0.533,9.0,79,20,58,0.253,190,0.416,19,0.462,9.7
486,201163,Wilson Chandler,1610612743,DEN,78,28,50,2471.0,96,65,24,0.677,287,0.334,4,0.339,6.2,379,105,274,0.277,629,0.603,54,0.659,5.3,475,170,298,0.358,916,0.519,58,0.554,5.5
487,202333,Xavier Henry,1610612747,LAL,9,1,8,86.0,2,0,2,0.0,7,0.286,0,0.286,14.7,2,0,2,0.0,11,0.182,3,0.25,3.1,4,0,4,0.0,18,0.222,3,0.267,8.9
488,203897,Zach LaVine,1610612750,MIN,76,15,61,1867.0,27,10,19,0.37,126,0.214,4,0.221,11.5,184,32,150,0.174,336,0.548,26,0.594,7.5,211,42,169,0.199,462,0.457,30,0.488,8.1
489,2216,Zach Randolph,1610612763,MEM,71,51,20,2304.0,225,190,28,0.844,552,0.408,12,0.417,4.3,522,169,349,0.324,818,0.638,58,0.687,4.7,747,359,377,0.481,1370,0.545,70,0.575,4.5
490,2585,Zaza Pachulia,1610612749,MIL,72,33,39,1702.0,190,131,53,0.689,431,0.441,19,0.461,5.6,296,122,172,0.412,527,0.562,60,0.634,4.5,486,253,225,0.521,958,0.507,79,0.553,4.9
491,204054,Zoran Dragic,1610612748,MIA,16,6,10,75.0,5,2,3,0.4,15,0.333,1,0.357,13.5,3,1,2,0.333,8,0.375,2,0.5,7.7,8,3,5,0.375,23,0.348,3,0.4,11.4
