,PLAYER_ID,PLAYER_NAME,TEAM_ID,TEAM_ABBREVIATION,GP,W,L,MIN,OREB,OREB_CONTEST,OREB_UNCONTEST,OREB_CONTEST_PCT,OREB_CHANCES,OREB_CHANCE_PCT,OREB_CHANCE_DEFER,OREB_CHANCE_PCT_ADJ,AVG_OREB_DIST,DREB,DREB_CONTEST,DREB_UNCONTEST,DREB_CONTEST_PCT,DREB_CHANCES,DREB_CHANCE_PCT,DREB_CHANCE_DEFER,DREB_CHANCE_PCT_ADJ,AVG_DREB_DIST,REB,REB_CONTEST,REB_UNCONTEST,REB_CONTEST_PCT,REB_CHANCES,REB_CHANCE_PCT,REB_CHANCE_DEFER,REB_CHANCE_PCT_ADJ,AVG_REB_DIST
0,201166,Aaron Brooks,1610612741,CHI,69,36,33,1108.0,21,8,13,0.381,107,0.196,6,0.208,13.7,80,14,66,0.175,160,0.5,13,0.544,10.7,101,22,79,0.218,267,0.378,19,0.407,11.3
1,203932,Aaron Gordon,1610612753,ORL,77,32,45,1857.0,154,113,36,0.734,318,0.484,6,0.494,5.7,352,112,235,0.318,517,0.681,34,0.729,5.3,506,225,271,0.445,835,0.606,40,0.636,5.4
2,1626151,Aaron Harrison,1610612766,CHA,21,15,6,93.0,4,1,2,0.25,7,0.571,0,0.571,14.1,11,0,11,0.0,19,0.579,2,0.647,8.8,15,1,13,0.067,26,0.577,2,0.625,9.9
3,203940,Adreian Payne,1610612750,MIN,52,18,34,486.0,20,13,7,0.65,49,0.408,4,0.444,6.1,91,30,61,0.33,143,0.636,7,0.669,5.2,111,43,68,0.387,192,0.578,11,0.613,5.3
4,201143,Al Horford,1610612737,ATL,82,48,34,2631.0,148,88,56,0.595,329,0.45,4,0.455,7.3,448,160,285,0.357,865,0.518,75,0.567,6.0,596,248,341,0.416,1194,0.499,79,0.535,6.3
5,2744,Al Jefferson,1610612766,CHA,47,33,14,1096.0,57,35,22,0.614,157,0.363,8,0.383,5.9,244,68,175,0.279,388,0.629,40,0.701,4.0,301,103,197,0.342,545,0.552,48,0.606,4.4
6,202329,Al-Farouq Aminu,1610612757,POR,82,44,38,2341.0,98,49,45,0.5,270,0.363,12,0.38,8.8,401,116,284,0.289,641,0.626,48,0.676,6.0,499,165,329,0.331,911,0.548,60,0.586,6.5
7,101187,Alan Anderson,1610612764,WAS,13,8,5,192.0,1,0,1,0.0,15,0.067,0,0.067,35.4,26,5,21,0.192,48,0.542,6,0.619,5.7,27,5,22,0.185,63,0.429,6,0.474,6.8
8,1626210,Alan Williams,1610612756,PHX,10,3,7,68.0,14,11,2,0.786,31,0.452,2,0.483,4.9,24,11,13,0.458,30,0.8,1,0.828,3.3,38,22,15,0.579,61,0.623,3,0.655,3.8
9,202692,Alec Burks,1610612762,UTA,31,13,18,797.0,16,4,11,0.25,84,0.19,2,0.195,14.3,93,21,73,0.226,177,0.525,12,0.564,7.5,109,25,84,0.229,261,0.418,14,0.441,8.4
10,203458,Alex Len,1610612756,PHX,78,23,55,1821.0,178,118,50,0.663,424,0.42,9,0.429,5.9,416,148,264,0.356,701,0.593,56,0.645,4.2,594,266,314,0.448,1125,0.528,65,0.56,4.7
11,1627293,Alex Stepheson,1610612763,MEM,8,2,6,72.0,19,14,5,0.737,34,0.559,0,0.559,4.5,9,5,4,0.556,22,0.409,4,0.5,5.2,28,19,9,0.679,56,0.5,4,0.538,4.7
12,201582,Alexis Ajinca,1610612740,NOP,59,20,39,861.0,75,51,22,0.68,153,0.49,3,0.5,5.4,194,62,131,0.32,319,0.608,27,0.664,4.0,269,113,153,0.42,472,0.57,30,0.609,4.4
13,203459,Allen Crabbe,1610612757,POR,81,43,38,2105.0,27,8,19,0.296,117,0.231,3,0.237,14.5,189,38,148,0.201,314,0.602,38,0.685,7.6,216,46,167,0.213,431,0.501,41,0.554,8.5
14,202087,Alonzo Gee,1610612740,NOP,73,27,46,1632.0,60,28,29,0.467,189,0.317,3,0.323,7.5,185,54,129,0.292,318,0.582,25,0.631,7.0,245,82,158,0.335,507,0.483,28,0.511,7.1
15,2405,Amar'e Stoudemire,1610612748,MIA,52,30,22,762.0,65,53,12,0.815,155,0.419,0,0.419,4.7,157,42,115,0.268,307,0.511,27,0.561,4.2,222,95,127,0.428,462,0.481,27,0.51,4.3
16,101161,Amir Johnson,1610612738,BOS,78,44,34,1777.0,177,120,54,0.678,381,0.465,6,0.472,5.8,321,141,176,0.439,592,0.542,60,0.603,4.9,498,261,230,0.524,973,0.512,66,0.549,5.2
17,2760,Anderson Varejao,1610612744,GSW,53,41,12,496.0,37,22,14,0.595,99,0.374,4,0.389,5.9,104,34,69,0.327,169,0.615,13,0.667,4.1,141,56,83,0.397,268,0.526,17,0.562,4.6
18,203083,Andre Drummond,1610612765,DET,81,43,38,2665.0,395,290,83,0.734,700,0.564,7,0.57,4.8,803,329,470,0.41,1133,0.709,76,0.76,3.4,1198,619,553,0.517,1833,0.654,83,0.685,3.8
19,2738,Andre Iguodala,1610612744,GSW,65,59,6,1732.0,52,25,27,0.481,124,0.419,3,0.43,12.1,211,43,168,0.204,343,0.615,24,0.661,8.4,263,68,195,0.259,467,0.563,27,0.598,9.1
20,1889,Andre Miller,1610612759,SAS,39,20,19,461.0,12,7,5,0.583,36,0.333,1,0.343,7.2,39,8,31,0.205,77,0.506,3,0.527,9.5,51,15,36,0.294,113,0.451,4,0.468,8.9
21,203460,Andre Roberson,1610612760,OKC,70,48,22,1553.0,79,53,26,0.671,216,0.366,8,0.38,7.3,172,47,128,0.273,314,0.548,23,0.591,6.5,251,100,154,0.398,530,0.474,31,0.503,6.8
22,200745,Andrea Bargnani,1610612751,BKN,46,11,35,634.0,28,16,11,0.571,58,0.483,0,0.483,7.2,69,25,46,0.362,143,0.483,7,0.507,5.7,97,41,57,0.423,201,0.483,7,0.5,6.1
23,101106,Andrew Bogut,1610612744,GSW,70,62,8,1451.0,121,91,29,0.752,202,0.599,3,0.608,5.1,371,146,224,0.394,645,0.575,56,0.63,3.9,492,237,253,0.482,847,0.581,59,0.624,4.2
24,202726,Andrew Goudelock,1610612745,HOU,8,5,3,50.0,1,1,0,1.0,4,0.25,0,0.25,28.9,1,1,0,1.0,8,0.125,1,0.143,5.0,2,2,0,1.0,12,0.167,1,0.182,16.9
25,203094,Andrew Nicholson,1610612753,ORL,55,22,33,820.0,34,16,17,0.471,87,0.391,4,0.41,8.3,167,70,97,0.419,256,0.652,13,0.687,4.1,201,86,114,0.428,343,0.586,17,0.617,4.8
26,203952,Andrew Wiggins,1610612750,MIN,81,29,52,2845.0,105,62,42,0.59,351,0.299,13,0.311,8.0,186,56,132,0.301,355,0.524,15,0.547,8.3,291,118,174,0.405,706,0.412,28,0.429,8.2
27,203461,Anthony Bennett,1610612761,TOR,19,12,7,84.0,6,5,1,0.833,16,0.375,0,0.375,5.6,17,4,13,0.235,21,0.81,1,0.85,5.2,23,9,14,0.391,37,0.622,1,0.639,5.3
28,1626148,Anthony Brown,1610612747,LAL,29,4,25,599.0,9,2,8,0.222,43,0.209,3,0.225,17.5,61,15,48,0.246,112,0.545,9,0.592,7.2,70,17,56,0.243,155,0.452,12,0.49,8.6
29,203076,Anthony Davis,1610612740,NOP,61,24,37,2164.0,130,88,36,0.677,250,0.52,4,0.528,6.7,497,170,323,0.342,667,0.745,34,0.785,4.9,627,258,359,0.411,917,0.684,38,0.713,5.3
30,201627,Anthony Morrow,1610612760,OKC,68,46,22,926.0,10,3,9,0.3,41,0.244,0,0.244,14.5,52,18,34,0.346,104,0.5,6,0.531,9.3,62,21,43,0.339,145,0.428,6,0.446,10.5
31,201229,Anthony Tolliver,1610612765,DET,72,36,36,1341.0,39,13,23,0.333,100,0.39,3,0.402,13.3,190,53,132,0.279,335,0.567,38,0.64,5.9,229,66,155,0.288,435,0.526,41,0.581,7.1
32,203462,Archie Goodwin,1610612756,PHX,57,14,43,1114.0,27,13,11,0.481,137,0.197,10,0.213,8.4,115,26,90,0.226,197,0.584,18,0.642,6.7,142,39,101,0.275,334,0.425,28,0.464,7.0
33,203382,Aron Baynes,1610612765,DET,81,43,38,1233.0,140,98,38,0.7,342,0.409,5,0.415,5.4,244,102,144,0.418,421,0.58,40,0.64,4.7,384,200,182,0.521,763,0.503,45,0.535,5.0
34,201167,Arron Afflalo,1610612752,NYK,71,27,44,2371.0,23,8,16,0.348,151,0.152,6,0.159,15.3,243,27,217,0.111,418,0.581,34,0.633,8.5,266,35,233,0.132,569,0.467,40,0.503,9.1
35,203085,Austin Rivers,1610612746,LAC,67,42,25,1464.0,22,11,11,0.5,101,0.218,3,0.224,11.5,108,13,97,0.12,257,0.42,22,0.46,8.9,130,24,108,0.185,358,0.363,25,0.39,9.4
36,202340,Avery Bradley,1610612738,BOS,75,44,31,2507.0,48,14,34,0.292,161,0.298,5,0.308,13.2,169,16,153,0.095,342,0.494,26,0.535,7.6,217,30,187,0.138,503,0.431,31,0.46,8.8
37,1626253,Axel Toupane,1610612743,DEN,21,9,12,305.0,8,2,6,0.25,22,0.364,0,0.364,12.2,23,3,19,0.13,48,0.479,2,0.5,11.7,31,5,25,0.161,70,0.443,2,0.456,11.8
38,203463,Ben McLemore,1610612758,SAC,67,28,39,1418.0,33,12,21,0.364,121,0.273,8,0.292,11.2,111,15,96,0.135,251,0.442,34,0.512,8.2,144,27,117,0.188,372,0.387,42,0.436,8.9
39,2757,Beno Udrih,1610612763,MEM,44,26,18,708.0,8,0,8,0.0,48,0.167,3,0.178,17.3,64,10,56,0.156,125,0.512,11,0.561,11.2,72,10,64,0.139,173,0.416,14,0.453,11.8
40,202687,Bismack Biyombo,1610612761,TOR,81,55,26,1787.0,180,132,47,0.733,439,0.41,11,0.421,5.2,469,183,286,0.39,775,0.605,65,0.661,3.9,649,315,333,0.485,1214,0.535,76,0.57,4.2
41,201933,Blake Griffin,1610612746,LAC,35,22,13,1170.0,51,31,17,0.608,130,0.392,11,0.429,6.8,243,88,152,0.362,412,0.59,23,0.625,5.1,294,119,169,0.405,542,0.542,34,0.579,5.3
42,1626246,Boban Marjanovic,1610612759,SAS,54,47,7,508.0,73,59,9,0.808,134,0.545,5,0.566,3.9,121,49,71,0.405,183,0.661,10,0.699,3.7,194,108,80,0.557,317,0.612,15,0.642,3.7
43,1626171,Bobby Portis,1610612741,CHI,62,29,33,1102.0,123,80,41,0.65,283,0.435,8,0.447,5.6,214,62,154,0.29,342,0.626,26,0.677,4.6,337,142,195,0.421,625,0.539,34,0.57,5.0
44,202711,Bojan Bogdanovic,1610612751,BKN,79,21,58,2115.0,36,15,21,0.417,185,0.195,11,0.207,13.3,219,36,178,0.164,334,0.656,22,0.702,7.9,255,51,199,0.2,519,0.491,33,0.525,8.7
45,2564,Boris Diaw,1610612759,SAS,76,64,12,1386.0,58,27,32,0.466,159,0.365,5,0.377,8.8,175,66,108,0.377,344,0.509,30,0.557,5.6,233,93,140,0.399,503,0.463,35,0.498,6.4
46,203078,Bradley Beal,1610612764,WAS,55,28,27,1708.0,41,20,22,0.488,143,0.287,6,0.299,14.1,147,31,113,0.211,234,0.628,7,0.648,7.5,188,51,135,0.271,377,0.499,13,0.516,9.0
47,201148,Brandan Wright,1610612763,MEM,12,6,6,212.0,14,11,3,0.786,35,0.4,0,0.4,5.9,29,12,16,0.414,55,0.527,4,0.569,6.0,43,23,19,0.535,90,0.478,4,0.5,6.0
48,1626183,Branden Dawson,1610612746,LAC,6,5,1,29.0,2,1,1,0.5,5,0.4,0,0.4,8.8,2,2,0,1.0,9,0.222,2,0.286,3.9,4,3,1,0.75,14,0.286,2,0.333,6.3
49,101138,Brandon Bass,1610612747,LAL,66,16,50,1342.0,104,59,43,0.567,248,0.419,6,0.43,7.7,181,51,126,0.282,344,0.526,29,0.575,6.2,285,110,169,0.386,592,0.481,35,0.512,6.7
50,201943,Brandon Jennings,1610612753,ORL,48,20,28,867.0,16,5,10,0.313,47,0.34,0,0.34,15.7,80,6,76,0.075,145,0.552,14,0.611,9.0,96,11,86,0.115,192,0.5,14,0.539,10.0
51,202688,Brandon Knight,1610612756,PHX,52,16,36,1870.0,36,11,23,0.306,128,0.281,7,0.298,15.8,166,27,138,0.163,320,0.519,20,0.553,8.1,202,38,161,0.188,448,0.451,27,0.48,9.4
52,201575,Brandon Rush,1610612744,GSW,72,63,9,1055.0,21,8,12,0.381,65,0.323,2,0.333,12.1,160,46,113,0.288,267,0.599,26,0.664,6.3,181,54,125,0.298,332,0.545,28,0.595,6.9
53,203148,Brian Roberts,1610612757,POR,51,26,25,470.0,6,0,5,0.0,22,0.273,0,0.273,24.8,35,2,33,0.057,64,0.547,2,0.565,8.4,41,2,38,0.049,86,0.477,2,0.488,10.5
54,1627362,Briante Weber,1610612748,MIA,7,3,4,169.0,8,2,4,0.25,13,0.615,1,0.667,20.6,17,3,14,0.176,32,0.531,3,0.586,8.4,25,5,18,0.2,45,0.556,4,0.61,11.6
55,201572,Brook Lopez,1610612751,BKN,73,21,52,2457.0,204,152,45,0.745,406,0.502,10,0.515,5.7,369,161,203,0.436,653,0.565,64,0.626,5.9,573,313,248,0.546,1059,0.541,74,0.582,5.8
56,203998,Bruno Caboclo,1610612761,TOR,6,6,0,43.0,1,1,0,1.0,3,0.333,0,0.333,3.3,1,0,1,0.0,5,0.2,0,0.2,3.6,2,1,1,0.5,8,0.25,0,0.25,3.5
57,203955,Bryce Cotton,1610612763,MEM,8,1,7,39.0,0,0,0,0.0,2,0.0,0,0.0,0.0,0,0,0,0.0,3,0.0,0,0.0,0.0,0,0,0,0.0,5,0.0,0,0.0,0.0
58,1626214,Bryce Dejean-Jones,1610612740,NOP,14,8,6,279.0,8,3,5,0.375,22,0.364,1,0.381,10.2,40,11,29,0.275,65,0.615,7,0.69,6.7,48,14,34,0.292,87,0.552,8,0.608,7.3
59,201228,C.J. Watson,1610612753,ORL,33,14,19,656.0,10,4,6,0.4,28,0.357,1,0.37,15.1,56,6,51,0.107,96,0.583,10,0.651,10.0,66,10,57,0.152,124,0.532,11,0.584,10.7
60,203468,CJ McCollum,1610612757,POR,80,44,36,2780.0,47,13,34,0.277,232,0.203,11,0.213,14.3,212,34,178,0.16,417,0.508,38,0.559,9.3,259,47,212,0.181,649,0.399,49,0.432,10.2
61,101139,CJ Miles,1610612754,IND,64,34,30,1464.0,25,17,9,0.68,91,0.275,2,0.281,8.4,150,51,103,0.34,300,0.5,30,0.556,6.2,175,68,112,0.389,391,0.448,32,0.487,6.5
62,203912,CJ Wilcox,1610612746,LAC,23,15,8,167.0,1,0,1,0.0,6,0.167,0,0.167,23.6,11,3,8,0.273,26,0.423,4,0.5,9.8,12,3,9,0.25,32,0.375,4,0.429,11.0
63,203946,Cameron Bairstow,1610612765,DET,18,4,14,103.0,4,3,1,0.75,25,0.16,0,0.16,2.4,24,6,18,0.25,40,0.6,3,0.649,6.3,28,9,19,0.321,65,0.431,3,0.452,5.7
64,1626166,Cameron Payne,1610612760,OKC,57,44,13,698.0,9,3,6,0.333,52,0.173,1,0.176,13.2,76,6,72,0.079,130,0.585,7,0.618,6.8,85,9,78,0.106,182,0.467,8,0.489,7.4
65,201171,Carl Landry,1610612755,PHI,36,5,31,569.0,49,35,14,0.714,102,0.48,2,0.49,5.4,97,23,73,0.237,168,0.577,21,0.66,5.1,146,58,87,0.397,270,0.541,23,0.591,5.2
66,2546,Carmelo Anthony,1610612752,NYK,72,32,40,2530.0,98,66,26,0.673,288,0.34,8,0.35,6.9,458,89,367,0.194,646,0.709,35,0.75,6.3,556,155,393,0.279,934,0.595,43,0.624,6.4
67,2406,Caron Butler,1610612758,SAC,16,2,14,168.0,5,2,3,0.4,9,0.556,0,0.556,17.4,17,3,14,0.176,40,0.425,4,0.472,7.2,22,5,17,0.227,49,0.449,4,0.489,9.5
68,202718,Chandler Parsons,1610612742,DAL,61,29,32,1799.0,29,6,24,0.207,134,0.216,12,0.238,15.7,256,60,197,0.234,401,0.638,25,0.681,6.5,285,66,221,0.232,535,0.533,37,0.572,7.5
69,101112,Channing Frye,1610612739,CLE,69,35,34,1177.0,35,19,15,0.543,65,0.538,1,0.547,9.7,193,58,131,0.301,350,0.551,25,0.594,4.4,228,77,146,0.338,415,0.549,26,0.586,5.2
70,101111,Charlie Villanueva,1610612742,DAL,62,29,33,665.0,24,17,8,0.708,72,0.333,4,0.353,8.3,128,29,98,0.227,195,0.656,11,0.696,5.1,152,46,106,0.303,267,0.569,15,0.603,5.6
71,201978,Chase Budinger,1610612756,PHX,66,29,37,930.0,43,16,25,0.372,91,0.473,1,0.478,8.4,107,25,83,0.234,189,0.566,19,0.629,7.3,150,41,108,0.273,280,0.536,20,0.577,7.6
72,2365,Chris Andersen,1610612763,MEM,27,11,16,403.0,36,29,7,0.806,77,0.468,2,0.48,4.9,62,26,38,0.419,109,0.569,9,0.62,4.1,98,55,45,0.561,186,0.527,11,0.56,4.4
73,2547,Chris Bosh,1610612748,MIA,53,29,24,1778.0,48,31,17,0.646,120,0.4,2,0.407,9.1,342,104,235,0.304,544,0.629,38,0.676,5.3,390,135,252,0.346,664,0.587,40,0.625,5.8
74,203142,Chris Copeland,1610612749,MIL,24,10,14,156.0,1,1,0,1.0,13,0.077,1,0.083,2.5,9,2,7,0.222,34,0.265,3,0.29,4.9,10,3,7,0.3,47,0.213,4,0.233,4.6
75,203187,Chris Johnson,1610612762,UTA,70,38,32,857.0,27,10,16,0.37,66,0.409,4,0.435,12.8,105,25,81,0.238,186,0.565,16,0.618,7.2,132,35,97,0.265,252,0.524,20,0.569,8.3
76,2549,Chris Kaman,1610612757,POR,16,11,5,112.0,7,4,3,0.571,15,0.467,0,0.467,7.4,17,8,9,0.471,39,0.436,3,0.472,3.9,24,12,12,0.5,54,0.444,3,0.471,4.9
77,1626191,Chris McCullough,1610612751,BKN,24,7,17,362.0,25,11,13,0.44,62,0.403,0,0.403,7.9,43,13,31,0.302,94,0.457,11,0.518,5.8,68,24,44,0.353,156,0.436,11,0.469,6.5
78,101108,Chris Paul,1610612746,LAC,74,50,24,2420.0,39,12,26,0.308,170,0.229,13,0.248,14.4,271,57,217,0.21,527,0.514,31,0.546,9.5,310,69,243,0.223,697,0.445,44,0.475,10.1
79,1626174,Christian Wood,1610612755,PHI,17,0,17,145.0,13,5,7,0.385,27,0.481,0,0.481,4.8,25,15,11,0.6,51,0.49,7,0.568,5.4,38,20,18,0.526,78,0.487,7,0.535,5.2
80,101236,Chuck Hayes,1610612746,LAC,2,1,1,24.0,0,0,0,0.0,1,0.0,0,0.0,0.0,8,4,4,0.5,13,0.615,0,0.615,3.0,8,4,4,0.5,14,0.571,0,0.571,3.0
81,203921,Cleanthony Early,1610612752,NYK,17,6,11,154.0,4,2,2,0.5,21,0.19,0,0.19,8.5,22,3,19,0.136,44,0.5,4,0.55,6.1,26,5,21,0.192,65,0.4,4,0.426,6.5
82,1626146,Cliff Alexander,1610612757,POR,8,3,5,36.0,2,2,0,1.0,7,0.286,0,0.286,3.1,4,1,3,0.25,9,0.444,2,0.571,7.0,6,3,3,0.5,16,0.375,2,0.429,5.7
83,203991,Clint Capela,1610612745,HOU,77,39,38,1471.0,194,157,36,0.809,410,0.473,10,0.485,5.0,300,131,170,0.437,536,0.56,33,0.596,4.5,494,288,206,0.583,946,0.522,43,0.547,4.7
84,203469,Cody Zeller,1610612766,CHA,73,42,31,1774.0,138,93,45,0.674,384,0.359,10,0.369,5.7,317,118,195,0.372,594,0.534,60,0.594,4.9,455,211,240,0.464,978,0.465,70,0.501,5.2
85,202332,Cole Aldrich,1610612746,LAC,60,41,19,800.0,86,53,32,0.616,189,0.455,2,0.46,6.1,202,74,123,0.366,326,0.62,29,0.68,4.2,288,127,155,0.441,515,0.559,31,0.595,4.8
86,201147,Corey Brewer,1610612745,HOU,82,41,41,1669.0,42,14,26,0.333,162,0.259,5,0.268,11.8,157,36,121,0.229,305,0.515,31,0.573,8.6,199,50,147,0.251,467,0.426,36,0.462,9.2
87,203928,Cory Jefferson,1610612756,PHX,8,2,6,50.0,6,5,1,0.833,17,0.353,0,0.353,16.1,10,6,3,0.6,17,0.588,3,0.714,4.2,16,11,4,0.688,34,0.471,3,0.516,8.9
88,202709,Cory Joseph,1610612761,TOR,79,53,26,2011.0,38,14,24,0.368,203,0.187,8,0.195,11.2,169,37,136,0.219,387,0.437,24,0.466,8.1,207,51,160,0.246,590,0.351,32,0.371,8.6
89,1626262,Coty Clarke,1610612738,BOS,3,0,3,6.0,0,0,0,0.0,0,0.0,0,0.0,0.0,1,1,0,1.0,2,0.5,0,0.5,5.9,1,1,0,1.0,2,0.5,0,0.5,5.9
90,201584,Courtney Lee,1610612766,CHA,79,49,30,2334.0,29,8,20,0.276,106,0.274,5,0.287,16.5,176,27,148,0.153,285,0.618,15,0.652,8.9,205,35,168,0.171,391,0.524,20,0.553,10.0
91,1626245,Cristiano Felicio,1610612741,CHI,31,14,17,321.0,30,16,14,0.533,95,0.316,0,0.316,6.2,72,27,45,0.375,135,0.533,11,0.581,4.2,102,43,59,0.422,230,0.443,11,0.466,4.8
92,1626156,D'Angelo Russell,1610612747,LAL,80,17,63,2259.0,47,24,24,0.511,227,0.207,8,0.215,12.6,227,26,201,0.115,415,0.547,32,0.593,8.4,274,50,225,0.182,642,0.427,40,0.455,9.2
93,201571,D.J. Augustin,1610612743,DEN,62,35,27,1178.0,8,1,7,0.125,80,0.1,5,0.107,15.5,87,6,86,0.069,165,0.527,10,0.561,10.4,95,7,93,0.074,245,0.388,15,0.413,10.8
94,2563,Dahntay Jones,1610612739,CLE,1,0,1,42.0,1,0,1,0.0,9,0.111,0,0.111,6.3,4,0,4,0.0,10,0.4,1,0.444,9.0,5,0,5,0.0,19,0.263,1,0.278,8.5
95,203081,Damian Lillard,1610612757,POR,75,40,35,2676.0,45,14,34,0.311,236,0.191,13,0.202,14.6,257,38,225,0.148,478,0.538,39,0.585,8.7,302,52,259,0.172,714,0.423,52,0.456,9.6
96,203996,Damien Inglis,1610612749,MIL,20,5,15,156.0,2,1,1,0.5,18,0.111,0,0.111,12.2,29,9,20,0.31,45,0.644,1,0.659,5.7,31,10,21,0.323,63,0.492,1,0.5,6.1
97,204014,Damjan Rudez,1610612750,MIN,33,9,24,277.0,5,1,4,0.2,15,0.333,0,0.333,11.7,15,5,10,0.333,40,0.375,2,0.395,8.4,20,6,14,0.3,55,0.364,2,0.377,9.2
98,201568,Danilo Gallinari,1610612743,DEN,53,22,31,1839.0,52,33,19,0.635,173,0.301,4,0.308,7.3,229,55,174,0.24,374,0.612,36,0.678,6.6,281,88,193,0.313,547,0.514,40,0.554,6.7
99,201980,Danny Green,1610612759,SAS,79,65,14,2061.0,48,23,25,0.479,129,0.372,4,0.384,10.8,255,59,194,0.231,528,0.483,45,0.528,5.8,303,82,219,0.271,657,0.461,49,0.498,6.6
100,201967,Dante Cunningham,1610612740,NOP,80,28,52,1971.0,57,25,30,0.439,168,0.339,6,0.352,10.9,179,29,149,0.162,325,0.551,22,0.591,7.0,236,54,179,0.229,493,0.479,28,0.508,7.9
101,201589,Darrell Arthur,1610612743,DEN,70,26,44,1516.0,86,39,43,0.453,187,0.46,3,0.467,8.3,207,71,137,0.343,394,0.525,47,0.597,5.5,293,110,180,0.375,581,0.504,50,0.552,6.3
102,201954,Darren Collison,1610612758,SAC,73,29,44,2192.0,28,11,16,0.393,175,0.16,7,0.167,12.1,140,13,124,0.093,269,0.52,23,0.569,11.7,168,24,140,0.143,444,0.378,30,0.406,11.7
103,1626199,Darrun Hilliard,1610612765,DET,38,17,21,383.0,5,0,4,0.0,24,0.208,0,0.208,22.1,40,8,32,0.2,66,0.606,3,0.635,7.7,45,8,36,0.178,90,0.5,3,0.517,9.0
104,101135,David Lee,1610612742,DAL,54,26,28,888.0,100,69,27,0.69,227,0.441,5,0.45,6.3,202,60,139,0.297,352,0.574,28,0.623,4.3,302,129,166,0.427,579,0.522,33,0.553,5.0
105,2561,David West,1610612759,SAS,78,63,15,1404.0,72,51,21,0.708,189,0.381,6,0.393,6.9,237,81,155,0.342,427,0.555,41,0.614,5.4,309,132,176,0.427,616,0.502,47,0.543,5.7
106,201599,DeAndre Jordan,1610612746,LAC,77,51,26,2598.0,267,184,77,0.689,511,0.523,13,0.536,5.6,792,232,553,0.293,1147,0.69,72,0.737,4.6,1059,416,630,0.393,1658,0.639,85,0.673,4.9
107,201971,DeJuan Blair,1610612764,WAS,29,12,17,218.0,20,15,4,0.75,50,0.4,1,0.408,6.3,37,19,18,0.514,54,0.685,6,0.771,4.4,57,34,22,0.596,104,0.548,7,0.588,5.0
108,201942,DeMar DeRozan,1610612761,TOR,77,52,25,2764.0,62,35,29,0.565,244,0.254,11,0.266,10.7,276,58,218,0.21,473,0.584,33,0.627,7.9,338,93,247,0.275,717,0.471,44,0.502,8.4
109,202326,DeMarcus Cousins,1610612758,SAC,64,29,35,2221.0,154,110,32,0.714,402,0.383,12,0.395,5.0,586,230,354,0.392,871,0.673,47,0.711,4.5,740,340,386,0.459,1273,0.581,59,0.61,4.6
110,201960,DeMarre Carroll,1610612761,TOR,26,16,10,786.0,31,18,12,0.581,100,0.31,4,0.323,8.9,91,19,71,0.209,162,0.562,15,0.619,7.9,122,37,83,0.303,262,0.466,19,0.502,8.1
111,1626153,Delon Wright,1610612761,TOR,27,19,8,229.0,8,4,4,0.5,36,0.222,0,0.222,12.5,29,5,24,0.172,54,0.537,5,0.592,8.2,37,9,28,0.243,90,0.411,5,0.435,9.1
112,203471,Dennis Schroder,1610612737,ATL,80,47,33,1621.0,25,10,15,0.4,136,0.184,6,0.192,13.0,179,22,160,0.123,343,0.522,24,0.561,8.5,204,32,175,0.157,479,0.426,30,0.454,9.1
113,101114,Deron Williams,1610612742,DAL,65,31,34,2106.0,19,5,15,0.263,141,0.135,9,0.144,15.1,171,30,143,0.175,358,0.478,28,0.518,9.3,190,35,158,0.184,499,0.381,37,0.411,9.9
114,202324,Derrick Favors,1610612762,UTA,62,30,32,1983.0,169,124,45,0.734,390,0.433,8,0.442,6.3,334,139,191,0.416,570,0.586,49,0.641,4.6,503,263,236,0.523,960,0.524,57,0.557,5.2
115,201565,Derrick Rose,1610612741,CHI,66,32,34,2097.0,46,26,21,0.565,269,0.171,10,0.178,9.5,179,28,156,0.156,343,0.522,20,0.554,10.4,225,54,177,0.24,612,0.368,30,0.387,10.2
116,202682,Derrick Williams,1610612752,NYK,80,32,48,1435.0,47,23,22,0.489,142,0.331,3,0.338,9.4,249,49,201,0.197,359,0.694,19,0.732,5.4,296,72,223,0.243,501,0.591,22,0.618,6.0
117,1626164,Devin Booker,1610612756,PHX,76,20,56,2108.0,27,11,17,0.407,155,0.174,8,0.184,13.1,160,28,132,0.175,358,0.447,32,0.491,8.2,187,39,149,0.209,513,0.365,40,0.395,8.9
118,2734,Devin Harris,1610612742,DAL,64,35,29,1280.0,18,3,15,0.167,73,0.247,0,0.247,14.4,120,26,90,0.217,233,0.515,26,0.58,7.6,138,29,105,0.21,306,0.451,26,0.493,8.5
119,203906,Devyn Marble,1610612753,ORL,28,12,16,249.0,6,1,3,0.167,16,0.375,0,0.375,16.7,32,4,28,0.125,49,0.653,5,0.727,6.9,38,5,31,0.132,65,0.585,5,0.633,8.0
120,203473,Dewayne Dedmon,1610612753,ORL,58,21,37,705.0,67,44,19,0.657,139,0.482,5,0.5,6.4,161,59,103,0.366,241,0.668,16,0.716,4.4,228,103,122,0.452,380,0.6,21,0.635,5.0
121,203079,Dion Waiters,1610612760,OKC,78,53,25,2152.0,36,9,25,0.25,128,0.281,5,0.293,13.8,166,29,136,0.175,296,0.561,38,0.643,8.0,202,38,161,0.188,424,0.476,43,0.53,9.0
122,1717,Dirk Nowitzki,1610612742,DAL,75,38,37,2364.0,52,36,16,0.692,130,0.4,11,0.437,10.8,437,147,290,0.336,720,0.607,64,0.666,4.6,489,183,306,0.374,850,0.575,75,0.631,5.3
123,202388,Donald Sloan,1610612751,BKN,61,13,48,1318.0,17,4,13,0.235,77,0.221,6,0.239,15.8,156,18,137,0.115,251,0.622,14,0.658,8.3,173,22,150,0.127,328,0.527,20,0.562,9.0
124,202700,Donatas Motiejunas,1610612745,HOU,37,19,18,547.0,37,24,13,0.649,68,0.544,1,0.552,8.2,72,18,54,0.25,156,0.462,12,0.5,5.2,109,42,67,0.385,224,0.487,13,0.517,6.2
125,203926,Doug McDermott,1610612741,CHI,81,41,40,1861.0,37,17,19,0.459,123,0.301,8,0.322,12.8,158,32,124,0.203,316,0.5,37,0.566,7.2,195,49,143,0.251,439,0.444,45,0.495,8.2
126,203110,Draymond Green,1610612744,GSW,81,73,8,2808.0,134,95,35,0.709,326,0.411,8,0.421,6.3,635,239,392,0.376,993,0.639,58,0.679,4.8,769,334,427,0.434,1319,0.583,66,0.614,5.0
127,2400,Drew Gooden,1610612764,WAS,30,18,12,305.0,28,19,6,0.679,48,0.583,2,0.609,6.2,57,19,38,0.333,97,0.588,6,0.626,4.9,85,38,44,0.447,145,0.586,8,0.62,5.3
128,1626251,Duje Dukan,1610612758,SAC,1,0,1,24.0,2,1,1,0.5,4,0.5,0,0.5,7.5,2,0,2,0.0,5,0.4,1,0.5,7.0,4,1,3,0.25,9,0.444,1,0.5,7.3
129,2730,Dwight Howard,1610612745,HOU,71,34,37,2280.0,238,172,61,0.723,554,0.43,15,0.442,4.6,597,214,374,0.358,916,0.652,56,0.694,3.9,835,386,435,0.462,1470,0.568,71,0.597,4.1
130,203939,Dwight Powell,1610612742,DAL,69,35,34,992.0,84,54,30,0.643,218,0.385,8,0.4,6.3,189,48,138,0.254,293,0.645,16,0.682,4.6,273,102,168,0.374,511,0.534,24,0.561,5.2
131,2548,Dwyane Wade,1610612748,MIA,74,43,31,2258.0,82,47,33,0.573,243,0.337,8,0.349,7.5,220,49,172,0.223,390,0.564,30,0.611,8.3,302,96,205,0.318,633,0.477,38,0.508,8.1
132,202734,E'Twaun Moore,1610612741,CHI,59,29,30,1263.0,19,9,10,0.474,72,0.264,2,0.271,12.0,114,26,89,0.228,215,0.53,27,0.606,9.6,133,35,99,0.263,287,0.463,29,0.516,9.9
133,202334,Ed Davis,1610612757,POR,81,43,38,1684.0,224,150,66,0.67,513,0.437,15,0.45,5.6,375,143,236,0.381,660,0.568,68,0.633,4.5,599,293,302,0.489,1173,0.511,83,0.55,4.9
134,204002,Edy Tavares,1610612737,ATL,11,7,4,73.0,7,3,4,0.429,18,0.389,0,0.389,3.8,14,6,8,0.429,24,0.583,5,0.737,4.2,21,9,12,0.429,42,0.5,5,0.568,4.1
135,203901,Elfrid Payton,1610612753,ORL,72,32,40,2125.0,77,36,37,0.468,256,0.301,12,0.316,9.9,183,26,159,0.142,336,0.545,37,0.612,9.0,260,62,196,0.238,592,0.439,49,0.479,9.3
136,202407,Elijah Millsap,1610612762,UTA,20,9,11,173.0,6,4,2,0.667,27,0.222,1,0.231,10.8,29,10,19,0.345,48,0.604,3,0.644,7.3,35,14,21,0.4,75,0.467,4,0.493,7.9
137,202343,Elliot Williams,1610612766,CHA,5,4,1,45.0,1,0,1,0.0,2,0.5,0,0.5,17.6,3,1,2,0.333,3,1.0,0,1.0,5.2,4,1,3,0.25,5,0.8,0,0.8,8.3
138,1882,Elton Brand,1610612755,PHI,17,2,15,225.0,9,6,3,0.667,23,0.391,0,0.391,7.8,54,17,36,0.315,82,0.659,3,0.684,6.3,63,23,39,0.365,105,0.6,3,0.618,6.5
139,1626144,Emmanuel Mudiay,1610612743,DEN,68,29,39,2068.0,32,16,14,0.5,177,0.181,5,0.186,11.3,200,24,177,0.12,403,0.496,35,0.543,8.7,232,40,191,0.172,580,0.4,40,0.43,9.0
140,202683,Enes Kanter,1610612760,OKC,82,55,27,1721.0,249,200,33,0.803,563,0.442,17,0.456,4.1,415,153,262,0.369,687,0.604,58,0.66,4.0,664,353,295,0.532,1250,0.531,75,0.565,4.0
141,202339,Eric Bledsoe,1610612756,PHX,31,12,19,1059.0,18,7,12,0.389,100,0.18,4,0.188,11.8,107,20,85,0.187,196,0.546,20,0.608,9.0,125,27,97,0.216,296,0.422,24,0.46,9.3
142,201569,Eric Gordon,1610612740,NOP,45,14,31,1481.0,10,1,9,0.1,65,0.154,0,0.154,18.3,89,11,79,0.124,171,0.52,11,0.556,8.8,99,12,88,0.121,236,0.419,11,0.44,9.7
143,203961,Eric Moreland,1610612758,SAC,7,1,6,43.0,3,2,1,0.667,17,0.176,0,0.176,6.9,6,5,1,0.833,13,0.462,3,0.6,4.3,9,7,2,0.778,30,0.3,3,0.333,5.2
144,203475,Erick Green,1610612743,DEN,9,6,3,42.0,3,0,3,0.0,4,0.75,0,0.75,21.8,3,0,3,0.0,7,0.429,1,0.5,5.7,6,0,6,0.0,11,0.545,1,0.6,13.7
145,101141,Ersan Ilyasova,1610612753,ORL,74,35,39,1880.0,144,97,40,0.674,318,0.453,9,0.466,5.8,259,89,167,0.344,450,0.576,55,0.656,5.7,403,186,207,0.462,768,0.525,64,0.572,5.7
146,203095,Evan Fournier,1610612753,ORL,78,33,45,2532.0,32,10,22,0.313,209,0.153,2,0.155,11.8,190,37,153,0.195,362,0.525,27,0.567,8.7,222,47,175,0.212,571,0.389,29,0.41,9.2
147,202323,Evan Turner,1610612738,BOS,80,46,34,2244.0,50,23,25,0.46,205,0.244,6,0.251,13.4,346,60,285,0.173,511,0.677,33,0.724,6.3,396,83,310,0.21,716,0.553,39,0.585,7.2
148,203105,Festus Ezeli,1610612744,GSW,46,42,4,770.0,91,67,20,0.736,229,0.397,4,0.404,4.6,166,79,85,0.476,315,0.527,36,0.595,3.8,257,146,105,0.568,544,0.472,40,0.51,4.1
149,1626163,Frank Kaminsky,1610612766,CHA,81,47,34,1708.0,69,41,27,0.594,211,0.327,9,0.342,8.0,266,87,182,0.327,503,0.529,39,0.573,5.3,335,128,209,0.382,714,0.469,48,0.503,5.9
150,202066,Garrett Temple,1610612764,WAS,80,40,40,1951.0,36,19,18,0.528,145,0.248,6,0.259,10.1,176,44,131,0.25,334,0.527,32,0.583,8.6,212,63,149,0.297,479,0.443,38,0.481,8.8
151,203914,Gary Harris,1610612743,DEN,76,31,45,2439.0,54,22,33,0.407,179,0.302,9,0.318,11.7,166,20,146,0.12,294,0.565,26,0.619,10.4,220,42,179,0.191,473,0.465,35,0.502,10.8
152,202390,Gary Neal,1610612764,WAS,40,18,22,807.0,11,4,6,0.364,39,0.282,2,0.297,13.1,72,7,67,0.097,148,0.486,12,0.529,7.6,83,11,73,0.133,187,0.444,14,0.48,8.2
153,201588,George Hill,1610612754,IND,74,41,33,2524.0,58,34,24,0.586,178,0.326,6,0.337,10.4,240,33,205,0.138,459,0.523,33,0.563,8.2,298,67,229,0.225,637,0.468,39,0.498,8.7
154,101123,Gerald Green,1610612748,MIA,69,40,29,1557.0,25,12,12,0.48,92,0.272,2,0.278,9.5,138,20,119,0.145,265,0.521,18,0.559,8.2,163,32,131,0.196,357,0.457,20,0.484,8.5
155,201945,Gerald Henderson,1610612757,POR,72,39,33,1431.0,30,8,21,0.267,99,0.303,4,0.316,12.9,181,30,150,0.166,293,0.618,25,0.675,7.3,211,38,171,0.18,392,0.538,29,0.581,8.1
156,203507,Giannis Antetokounmpo,1610612749,MIL,80,32,48,2823.0,113,75,34,0.664,360,0.314,15,0.328,6.9,499,154,339,0.309,800,0.624,47,0.663,5.9,612,229,373,0.374,1160,0.528,62,0.557,6.1
157,203922,Glenn Robinson III,1610612754,IND,45,24,21,508.0,12,6,7,0.5,55,0.218,2,0.226,13.0,56,10,45,0.179,114,0.491,13,0.554,7.2,68,16,52,0.235,169,0.402,15,0.442,8.3
158,201609,Goran Dragic,1610612748,MIA,72,44,28,2363.0,54,26,29,0.481,212,0.255,5,0.261,10.1,223,24,202,0.108,411,0.543,36,0.595,10.0,277,50,231,0.181,623,0.445,41,0.476,10.1
159,202330,Gordon Hayward,1610612762,UTA,80,38,42,2893.0,61,28,34,0.459,237,0.257,11,0.27,12.1,336,55,279,0.164,539,0.623,45,0.68,8.3,397,83,313,0.209,776,0.512,56,0.551,8.9
160,203476,Gorgui Dieng,1610612750,MIN,82,29,53,2220.0,157,98,57,0.624,393,0.399,6,0.406,7.1,428,142,280,0.332,700,0.611,61,0.67,5.4,585,240,337,0.41,1093,0.535,67,0.57,5.8
161,202328,Greg Monroe,1610612749,MIL,79,32,47,2314.0,218,158,54,0.725,511,0.427,17,0.441,5.1,478,190,280,0.397,738,0.648,56,0.701,4.6,696,348,334,0.5,1249,0.557,73,0.592,4.7
162,202962,Greg Smith,1610612750,MIN,18,8,10,192.0,12,7,6,0.583,36,0.333,1,0.343,8.1,30,7,22,0.233,47,0.638,3,0.682,3.7,42,14,28,0.333,83,0.506,4,0.532,5.1
163,202349,Greivis Vasquez,1610612749,MIL,23,9,14,460.0,5,3,3,0.6,29,0.172,0,0.172,21.2,42,6,36,0.143,93,0.452,10,0.506,8.3,47,9,39,0.191,122,0.385,10,0.42,9.7
164,203084,Harrison Barnes,1610612744,GSW,66,59,7,2042.0,77,39,35,0.506,206,0.374,9,0.391,9.0,248,66,182,0.266,489,0.507,58,0.575,6.8,325,105,217,0.323,695,0.468,67,0.518,7.3
165,202355,Hassan Whiteside,1610612748,MIA,73,42,31,2125.0,238,186,44,0.782,530,0.449,8,0.456,4.2,627,253,369,0.404,955,0.657,53,0.695,4.0,865,439,413,0.508,1485,0.582,61,0.607,4.1
166,203156,Henry Sims,1610612751,BKN,14,2,12,263.0,21,14,7,0.667,64,0.328,2,0.339,6.2,51,21,31,0.412,90,0.567,3,0.586,4.5,72,35,38,0.486,154,0.468,5,0.483,5.0
167,203138,Hollis Thompson,1610612755,PHI,77,10,67,2154.0,54,25,25,0.463,153,0.353,9,0.375,9.7,218,49,168,0.225,394,0.553,28,0.596,6.9,272,74,193,0.272,547,0.497,37,0.533,7.4
168,203546,Ian Clark,1610612744,GSW,66,59,7,578.0,13,7,7,0.538,48,0.271,2,0.283,13.6,55,11,46,0.2,109,0.505,12,0.567,9.1,68,18,53,0.265,157,0.433,14,0.476,10.0
169,101133,Ian Mahinmi,1610612754,IND,71,41,30,1816.0,138,78,57,0.565,285,0.484,6,0.495,7.3,369,150,217,0.407,635,0.581,71,0.654,5.2,507,228,274,0.45,920,0.551,77,0.601,5.8
170,202697,Iman Shumpert,1610612739,CLE,54,39,15,1316.0,32,18,14,0.563,93,0.344,7,0.372,11.7,171,29,142,0.17,272,0.629,14,0.663,6.6,203,47,156,0.232,365,0.556,21,0.59,7.4
171,203477,Isaiah Canaan,1610612755,PHI,77,10,67,1966.0,20,7,13,0.35,103,0.194,4,0.202,12.4,154,18,135,0.117,305,0.505,24,0.548,9.3,174,25,148,0.144,408,0.426,28,0.458,9.7
172,202738,Isaiah Thomas,1610612738,BOS,81,47,34,2610.0,46,17,29,0.37,279,0.165,13,0.173,12.5,191,21,171,0.11,376,0.508,29,0.55,10.8,237,38,200,0.16,655,0.362,42,0.387,11.2
173,202397,Ish Smith,1610612755,PHI,77,16,61,2239.0,43,13,30,0.302,192,0.224,5,0.23,13.0,262,27,238,0.103,519,0.505,51,0.56,8.3,305,40,268,0.131,711,0.429,56,0.466,8.9
174,200826,J.J. Barea,1610612742,DAL,74,38,36,1667.0,26,9,16,0.346,141,0.184,3,0.188,13.2,126,13,114,0.103,240,0.525,17,0.565,10.0,152,22,130,0.145,381,0.399,20,0.421,10.5
175,201581,JJ Hickson,1610612764,WAS,35,17,18,437.0,39,27,13,0.692,92,0.424,3,0.438,6.1,93,32,60,0.344,150,0.62,14,0.684,4.2,132,59,73,0.447,242,0.545,17,0.587,4.8
176,1626266,JJ O'Brien,1610612762,UTA,2,2,0,6.0,0,0,0,0.0,0,0.0,0,0.0,0.0,1,0,1,0.0,1,1.0,0,1.0,4.6,1,0,1,0.0,1,1.0,0,1.0,4.6
177,200755,JJ Redick,1610612746,LAC,75,50,25,2097.0,10,1,9,0.1,76,0.132,2,0.135,19.7,129,12,118,0.093,284,0.454,27,0.502,9.7,139,13,127,0.094,360,0.386,29,0.42,10.4
178,2747,JR Smith,1610612739,CLE,77,53,24,2362.0,43,10,30,0.233,111,0.387,6,0.41,16.9,174,24,152,0.138,297,0.586,30,0.652,8.2,217,34,182,0.157,408,0.532,36,0.583,9.9
179,203960,JaKarr Sampson,1610612743,DEN,73,18,55,1160.0,46,31,15,0.674,137,0.336,4,0.346,5.8,144,36,110,0.25,271,0.531,23,0.581,6.3,190,67,125,0.353,408,0.466,27,0.499,6.2
180,203210,JaMychal Green,1610612763,MEM,78,39,39,1446.0,139,104,29,0.748,294,0.473,13,0.495,5.9,234,82,150,0.35,380,0.616,30,0.669,4.7,373,186,179,0.499,674,0.553,43,0.591,5.1
181,201580,JaVale McGee,1610612742,DAL,34,15,19,370.0,53,35,16,0.66,101,0.525,2,0.535,5.0,80,31,47,0.388,137,0.584,9,0.625,4.1,133,66,63,0.496,238,0.559,11,0.586,4.5
182,203953,Jabari Parker,1610612749,MIL,76,32,44,2408.0,123,61,59,0.496,340,0.362,10,0.373,7.8,272,69,201,0.254,527,0.516,33,0.551,6.4,395,130,260,0.329,867,0.456,43,0.479,6.9
183,203109,Jae Crowder,1610612738,BOS,72,42,30,2278.0,70,29,39,0.414,207,0.338,11,0.357,11.2,300,60,238,0.2,451,0.665,33,0.718,7.2,370,89,277,0.241,658,0.562,44,0.603,8.0
184,1626143,Jahlil Okafor,1610612755,PHI,53,6,47,1591.0,122,82,38,0.672,313,0.39,6,0.397,6.1,251,102,148,0.406,471,0.533,50,0.596,4.7,373,184,186,0.493,784,0.476,56,0.512,5.1
185,2037,Jamal Crawford,1610612746,LAC,79,51,28,2126.0,20,6,14,0.3,95,0.211,10,0.235,9.8,125,14,112,0.112,267,0.468,16,0.498,10.3,145,20,126,0.138,362,0.401,26,0.432,10.3
186,2749,Jameer Nelson,1610612743,DEN,39,12,27,1036.0,19,2,17,0.105,62,0.306,0,0.306,18.4,96,15,82,0.156,193,0.497,19,0.552,8.6,115,17,99,0.148,255,0.451,19,0.487,10.2
187,202341,James Anderson,1610612758,SAC,50,19,31,717.0,13,6,7,0.462,41,0.317,0,0.317,10.1,72,19,53,0.264,129,0.558,8,0.595,7.4,85,25,60,0.294,170,0.5,8,0.525,7.8
188,203516,James Ennis III,1610612740,NOP,22,11,11,329.0,21,10,10,0.476,44,0.477,1,0.488,8.0,21,8,13,0.381,45,0.467,4,0.512,6.6,42,18,23,0.429,89,0.472,5,0.5,7.3
189,201935,James Harden,1610612745,HOU,82,41,41,3125.0,63,32,35,0.508,265,0.238,9,0.246,10.3,438,100,338,0.228,652,0.672,42,0.718,7.6,501,132,373,0.263,917,0.546,51,0.579,7.9
190,201949,James Johnson,1610612761,TOR,56,34,22,908.0,28,10,17,0.357,96,0.292,3,0.301,8.2,98,19,79,0.194,193,0.508,18,0.56,6.1,126,29,96,0.23,289,0.436,21,0.47,6.6
191,2592,James Jones,1610612739,CLE,48,33,15,463.0,8,2,5,0.25,23,0.348,0,0.348,19.6,42,8,34,0.19,85,0.494,10,0.56,7.6,50,10,39,0.2,108,0.463,10,0.51,9.3
192,203949,James Michael McAdoo,1610612744,GSW,41,37,4,262.0,30,19,8,0.633,79,0.38,0,0.38,6.7,28,10,18,0.357,71,0.394,11,0.467,6.6,58,29,26,0.5,150,0.387,11,0.417,6.7
193,203923,James Young,1610612738,BOS,28,11,17,196.0,4,1,3,0.25,13,0.308,0,0.308,15.8,22,7,16,0.318,33,0.667,2,0.71,6.2,26,8,19,0.308,46,0.565,2,0.591,7.6
194,203099,Jared Cunningham,1610612739,CLE,44,31,13,410.0,3,0,3,0.0,36,0.083,3,0.091,15.5,35,9,26,0.257,61,0.574,3,0.603,11.5,38,9,29,0.237,97,0.392,6,0.418,11.8
195,201162,Jared Dudley,1610612764,WAS,81,40,41,2098.0,54,26,25,0.481,183,0.295,9,0.31,10.7,232,67,167,0.289,591,0.393,70,0.445,7.6,286,93,192,0.325,774,0.37,79,0.412,8.2
196,203096,Jared Sullinger,1610612738,BOS,80,46,34,1900.0,194,131,61,0.675,400,0.485,8,0.495,5.7,476,212,261,0.445,755,0.63,43,0.669,4.6,670,343,322,0.512,1155,0.58,51,0.607,4.9
197,204067,Jarell Eddie,1610612764,WAS,26,13,13,147.0,2,1,1,0.5,5,0.4,0,0.4,27.1,21,2,19,0.095,29,0.724,2,0.778,8.5,23,3,20,0.13,34,0.676,2,0.719,10.1
198,1626185,Jarell Martin,1610612763,MEM,27,10,17,380.0,39,23,17,0.59,97,0.402,2,0.411,6.1,47,13,36,0.277,101,0.465,11,0.522,5.5,86,36,53,0.419,198,0.434,13,0.465,5.9
199,203950,Jarnell Stokes,1610612763,MEM,7,1,6,19.0,1,1,0,1.0,6,0.167,0,0.167,2.9,3,2,1,0.667,4,0.75,0,0.75,2.5,4,3,1,0.75,10,0.4,0,0.4,2.6
200,101127,Jarrett Jack,1610612751,BKN,32,10,22,1027.0,9,4,6,0.444,48,0.188,4,0.205,20.2,127,13,117,0.102,214,0.593,24,0.668,8.5,136,17,123,0.125,262,0.519,28,0.581,9.3
201,201160,Jason Smith,1610612753,ORL,75,33,42,1144.0,52,30,23,0.577,145,0.359,5,0.371,8.2,162,68,94,0.42,310,0.523,28,0.574,4.9,214,98,117,0.458,455,0.47,33,0.507,5.7
202,1891,Jason Terry,1610612745,HOU,72,37,35,1258.0,14,2,12,0.143,60,0.233,2,0.241,14.3,65,8,56,0.123,144,0.451,9,0.481,11.1,79,10,68,0.127,204,0.387,11,0.409,11.6
203,201574,Jason Thompson,1610612761,TOR,47,38,9,471.0,32,16,15,0.5,82,0.39,2,0.4,6.8,102,26,75,0.255,168,0.607,15,0.667,4.8,134,42,90,0.313,250,0.536,17,0.575,5.2
204,201965,Jeff Ayres,1610612746,LAC,17,11,6,107.0,4,4,0,1.0,18,0.222,1,0.235,3.8,18,5,13,0.278,31,0.581,1,0.6,4.3,22,9,13,0.409,49,0.449,2,0.468,4.2
205,201145,Jeff Green,1610612746,LAC,80,48,32,2253.0,74,42,29,0.568,217,0.341,8,0.354,9.0,258,74,182,0.287,472,0.547,37,0.593,6.5,332,116,211,0.349,689,0.482,45,0.516,7.0
206,201952,Jeff Teague,1610612737,ATL,79,47,32,2255.0,33,16,20,0.485,187,0.176,10,0.186,12.5,181,14,169,0.077,346,0.523,29,0.571,10.3,214,30,189,0.14,533,0.402,39,0.433,10.8
207,203481,Jeff Withey,1610612762,UTA,51,25,26,658.0,56,36,19,0.643,152,0.368,8,0.389,5.9,117,45,70,0.385,231,0.506,25,0.568,4.5,173,81,89,0.468,383,0.452,33,0.494,5.0
208,203924,Jerami Grant,1610612755,PHI,77,9,68,2066.0,99,61,39,0.616,259,0.382,6,0.391,6.4,262,81,180,0.309,535,0.49,49,0.539,5.6,361,142,219,0.393,794,0.455,55,0.488,5.8
209,202379,Jeremy Evans,1610612742,DAL,30,16,14,251.0,11,7,4,0.636,27,0.407,1,0.423,12.0,43,14,29,0.326,66,0.652,6,0.717,4.9,54,21,33,0.389,93,0.581,7,0.628,6.4
210,203087,Jeremy Lamb,1610612766,CHA,66,40,26,1227.0,44,23,23,0.523,110,0.4,2,0.407,7.8,208,34,175,0.163,358,0.581,34,0.642,5.6,252,57,198,0.226,468,0.538,36,0.583,6.1
211,202391,Jeremy Lin,1610612766,CHA,78,47,31,2048.0,42,13,25,0.31,169,0.249,7,0.259,14.9,211,44,167,0.209,448,0.471,41,0.518,8.3,253,57,192,0.225,617,0.41,48,0.445,9.3
212,1626170,Jerian Grant,1610612752,NYK,76,29,47,1265.0,23,6,16,0.261,114,0.202,4,0.209,12.0,120,21,100,0.175,254,0.472,33,0.543,8.3,143,27,116,0.189,368,0.389,37,0.432,8.8
213,201573,Jerryd Bayless,1610612749,MIL,52,21,31,1505.0,21,4,17,0.19,71,0.296,4,0.313,19.1,120,17,102,0.142,236,0.508,20,0.556,8.8,141,21,119,0.149,307,0.459,24,0.498,10.3
214,202690,Jimmer Fredette,1610612759,SAS,6,1,5,18.0,0,0,0,0.0,0,0.0,0,0.0,0.0,0,0,0,0.0,2,0.0,1,0.0,0.0,0,0,0,0.0,2,0.0,1,0.0,0.0
215,202710,Jimmy Butler,1610612741,CHI,67,37,30,2474.0,79,39,35,0.494,251,0.315,6,0.322,8.8,279,60,222,0.215,549,0.508,48,0.557,8.4,358,99,257,0.277,800,0.448,54,0.48,8.4
216,201149,Joakim Noah,1610612741,CHI,29,15,14,635.0,87,66,20,0.759,194,0.448,5,0.46,4.4,168,77,93,0.458,273,0.615,17,0.656,4.1,255,143,113,0.561,467,0.546,22,0.573,4.2
217,201975,Jodie Meeks,1610612765,DET,3,3,0,43.0,1,0,1,0.0,3,0.333,1,0.5,7.8,4,0,4,0.0,7,0.571,2,0.8,11.6,5,0,5,0.0,10,0.5,3,0.714,10.8
218,203925,Joe Harris,1610612739,CLE,5,5,0,15.0,0,0,0,0.0,1,0.0,0,0.0,0.0,3,0,3,0.0,4,0.75,0,0.75,4.1,3,0,3,0.0,5,0.6,0,0.6,4.1
219,204060,Joe Ingles,1610612762,UTA,81,40,41,1241.0,19,5,13,0.263,50,0.38,2,0.396,16.0,132,29,100,0.22,235,0.562,19,0.611,8.2,151,34,113,0.225,285,0.53,21,0.572,9.1
220,2207,Joe Johnson,1610612748,MIA,81,31,50,2703.0,49,25,23,0.51,178,0.275,8,0.288,10.3,243,36,209,0.148,415,0.586,38,0.645,8.0,292,61,232,0.209,593,0.492,46,0.534,8.4
221,1626202,Joe Young,1610612754,IND,41,19,22,384.0,6,0,6,0.0,27,0.222,0,0.222,18.2,44,5,39,0.114,76,0.579,4,0.611,9.1,50,5,45,0.1,103,0.485,4,0.505,10.2
222,201202,Joel Anthony,1610612765,DET,19,12,7,96.0,8,5,1,0.625,21,0.381,2,0.421,8.0,13,4,9,0.308,33,0.394,5,0.464,4.9,21,9,10,0.429,54,0.389,7,0.447,5.9
223,203530,Joffrey Lauvergne,1610612743,DEN,59,24,35,1041.0,77,47,26,0.61,212,0.363,4,0.37,6.5,213,66,144,0.31,337,0.632,22,0.676,4.3,290,113,170,0.39,549,0.528,26,0.554,4.9
224,203089,John Henson,1610612749,MIL,57,22,35,960.0,87,58,28,0.667,186,0.468,5,0.481,4.9,134,69,64,0.515,274,0.489,24,0.536,4.6,221,127,92,0.575,460,0.48,29,0.513,4.7
225,203098,John Jenkins,1610612756,PHX,43,18,25,480.0,8,3,5,0.375,29,0.276,2,0.296,13.5,49,8,41,0.163,89,0.551,11,0.628,8.4,57,11,46,0.193,118,0.483,13,0.543,9.1
226,202322,John Wall,1610612764,WAS,77,37,40,2784.0,42,11,32,0.262,228,0.184,12,0.194,15.9,337,40,296,0.119,535,0.63,34,0.673,8.6,379,51,328,0.135,763,0.497,46,0.529,9.5
227,203948,Johnny O'Bryant III,1610612749,MIL,66,27,39,857.0,65,47,16,0.723,143,0.455,7,0.478,5.0,111,41,72,0.369,223,0.498,15,0.534,6.3,176,88,88,0.5,366,0.481,22,0.512,5.9
228,202720,Jon Leuer,1610612756,PHX,67,22,45,1255.0,76,47,26,0.618,195,0.39,6,0.402,6.5,297,94,200,0.316,461,0.644,38,0.702,3.9,373,141,226,0.378,656,0.569,44,0.609,4.4
229,201973,Jonas Jerebko,1610612738,BOS,77,46,31,1160.0,74,46,28,0.622,192,0.385,6,0.398,8.3,208,55,152,0.264,348,0.598,25,0.644,5.5,282,101,180,0.358,540,0.522,31,0.554,6.2
230,202685,Jonas Valanciunas,1610612761,TOR,59,39,20,1527.0,181,154,26,0.851,413,0.438,4,0.443,4.0,357,144,208,0.403,560,0.638,46,0.695,3.6,538,298,234,0.554,973,0.553,50,0.583,3.8
231,203613,Jonathon Simmons,1610612759,SAS,55,47,8,813.0,16,6,10,0.375,64,0.25,4,0.267,16.0,80,14,65,0.175,140,0.571,21,0.672,7.6,96,20,75,0.208,204,0.471,25,0.536,9.0
232,203919,Jordan Adams,1610612763,MEM,2,0,2,15.0,0,0,0,0.0,0,0.0,0,0.0,0.0,2,0,2,0.0,3,0.667,1,1.0,11.0,2,0,2,0.0,3,0.667,1,1.0,11.0
233,203903,Jordan Clarkson,1610612747,LAL,79,17,62,2552.0,93,48,46,0.516,323,0.288,6,0.293,10.3,220,26,197,0.118,454,0.485,40,0.531,8.6,313,74,243,0.236,777,0.403,46,0.428,9.1
234,200770,Jordan Farmar,1610612763,MEM,12,2,10,291.0,4,2,2,0.5,23,0.174,3,0.2,19.0,21,6,15,0.286,42,0.5,2,0.525,8.9,25,8,17,0.32,65,0.385,5,0.417,10.5
235,202706,Jordan Hamilton,1610612740,NOP,11,4,7,304.0,12,8,4,0.667,36,0.333,2,0.353,9.7,50,8,42,0.16,88,0.568,9,0.633,5.7,62,16,46,0.258,124,0.5,11,0.549,6.4
236,201941,Jordan Hill,1610612754,IND,73,40,33,1513.0,156,106,44,0.679,359,0.435,12,0.45,6.3,295,98,195,0.332,478,0.617,42,0.677,4.5,451,204,239,0.452,837,0.539,54,0.576,5.1
237,203895,Jordan McRae,1610612739,CLE,22,10,12,196.0,4,2,3,0.5,15,0.267,0,0.267,9.0,16,0,16,0.0,28,0.571,4,0.667,8.9,20,2,19,0.1,43,0.465,4,0.513,8.9
238,1626175,Jordan Mickey,1610612738,BOS,16,9,7,57.0,6,4,1,0.667,24,0.25,1,0.261,2.8,7,2,5,0.286,20,0.35,3,0.412,3.1,13,6,6,0.462,44,0.295,4,0.325,3.0
239,203268,Jorge Gutierrez,1610612766,CHA,12,9,3,63.0,0,0,0,0.0,1,0.0,0,0.0,0.0,7,1,6,0.143,9,0.778,0,0.778,7.4,7,1,6,0.143,10,0.7,0,0.7,7.4
240,101181,Jose Calderon,1610612752,NYK,72,29,43,2024.0,22,6,15,0.273,84,0.262,5,0.278,18.5,207,24,185,0.116,375,0.552,30,0.6,8.5,229,30,200,0.131,459,0.499,35,0.54,9.5
241,203962,Josh Huestis,1610612760,OKC,5,2,3,55.0,2,2,0,1.0,8,0.25,2,0.333,7.8,8,3,5,0.375,13,0.615,2,0.727,5.6,10,5,5,0.5,21,0.476,4,0.588,6.0
242,201177,Josh McRoberts,1610612748,MIA,42,27,15,595.0,22,11,11,0.5,49,0.449,1,0.458,8.4,83,31,53,0.373,167,0.497,10,0.529,5.7,105,42,64,0.4,216,0.486,11,0.512,6.3
243,1626196,Josh Richardson,1610612748,MIA,52,29,23,1107.0,21,7,14,0.333,79,0.266,2,0.273,16.2,86,17,71,0.198,203,0.424,26,0.486,8.5,107,24,85,0.224,282,0.379,28,0.421,10.0
244,2746,Josh Smith,1610612745,HOU,55,31,24,880.0,51,32,14,0.627,121,0.421,6,0.443,7.0,141,66,76,0.468,295,0.478,35,0.542,5.1,192,98,90,0.51,416,0.462,41,0.512,5.6
245,201950,Jrue Holiday,1610612740,NOP,65,27,38,1831.0,27,19,9,0.704,141,0.191,7,0.201,9.6,168,30,138,0.179,312,0.538,32,0.6,7.7,195,49,147,0.251,453,0.43,39,0.471,8.0
246,203944,Julius Randle,1610612747,LAL,81,17,64,2286.0,172,127,42,0.738,496,0.347,17,0.359,6.1,657,212,440,0.323,981,0.67,70,0.721,4.2,829,339,482,0.409,1477,0.561,87,0.596,4.6
247,1626147,Justin Anderson,1610612742,DAL,55,28,27,647.0,18,5,13,0.278,51,0.353,2,0.367,12.2,114,25,88,0.219,176,0.648,13,0.699,4.7,132,30,101,0.227,227,0.581,15,0.623,5.7
248,202712,Justin Harper,1610612751,BKN,5,4,1,35.0,0,0,0,0.0,1,0.0,0,0.0,0.0,1,1,0,1.0,2,0.5,1,1.0,4.9,1,1,0,1.0,3,0.333,1,0.5,4.9
249,203200,Justin Holiday,1610612741,CHI,53,28,25,773.0,12,3,9,0.25,47,0.255,2,0.267,13.9,78,17,60,0.218,165,0.473,22,0.545,7.5,90,20,69,0.222,212,0.425,24,0.479,8.4
250,1626159,Justise Winslow,1610612748,MIA,78,46,32,2232.0,81,43,37,0.531,259,0.313,11,0.327,7.1,322,99,222,0.307,613,0.525,64,0.587,6.0,403,142,259,0.352,872,0.462,75,0.506,6.2
251,203994,Jusuf Nurkic,1610612743,DEN,32,14,18,547.0,65,50,15,0.769,159,0.409,1,0.411,4.7,110,38,66,0.345,207,0.531,25,0.604,4.3,175,88,81,0.503,366,0.478,26,0.515,4.5
252,203909,KJ McDaniels,1610612745,HOU,37,17,20,235.0,16,10,7,0.625,33,0.485,0,0.485,4.9,26,8,18,0.308,57,0.456,3,0.481,6.8,42,18,25,0.429,90,0.467,3,0.483,6.1
253,1626157,Karl-Anthony Towns,1610612750,MIN,82,29,53,2626.0,229,170,56,0.742,515,0.445,9,0.453,5.8,629,268,363,0.426,969,0.649,69,0.699,4.2,858,438,419,0.51,1484,0.578,78,0.61,4.6
254,202695,Kawhi Leonard,1610612759,SAS,72,60,12,2380.0,95,41,49,0.432,193,0.492,9,0.516,10.9,398,110,287,0.276,553,0.72,41,0.777,6.4,493,151,336,0.306,746,0.661,50,0.708,7.2
255,203951,Keith Appling,1610612753,ORL,5,0,5,27.0,0,0,0,0.0,0,0.0,0,0.0,0.0,1,0,1,0.0,5,0.2,0,0.2,7.9,1,0,1,0.0,5,0.2,0,0.2,7.9
256,203482,Kelly Olynyk,1610612738,BOS,68,39,29,1370.0,71,45,25,0.634,222,0.32,8,0.332,6.9,206,56,149,0.272,373,0.552,37,0.613,5.3,277,101,174,0.365,595,0.466,45,0.504,5.7
257,1626162,Kelly Oubre Jr.,1610612764,WAS,63,31,32,671.0,25,18,7,0.72,80,0.313,3,0.325,9.4,108,25,83,0.231,187,0.578,14,0.624,5.6,133,43,90,0.323,267,0.498,17,0.532,6.3
258,202689,Kemba Walker,1610612766,CHA,81,47,34,2885.0,56,21,34,0.375,232,0.241,12,0.255,12.5,301,30,273,0.1,541,0.556,62,0.628,8.9,357,51,307,0.143,773,0.462,74,0.511,9.4
259,203088,Kendall Marshall,1610612755,PHI,30,3,27,400.0,2,2,0,1.0,17,0.118,0,0.118,6.7,26,4,22,0.154,48,0.542,1,0.553,11.5,28,6,22,0.214,65,0.431,1,0.438,11.2
260,2570,Kendrick Perkins,1610612740,NOP,37,13,24,542.0,25,16,6,0.64,73,0.342,2,0.352,4.2,103,20,82,0.194,178,0.579,15,0.632,4.8,128,36,88,0.281,251,0.51,17,0.547,4.7
261,202702,Kenneth Faried,1610612743,DEN,67,26,41,1694.0,235,168,60,0.715,488,0.482,7,0.489,4.9,346,136,208,0.393,534,0.648,37,0.696,5.0,581,304,268,0.523,1022,0.568,44,0.594,4.9
262,203145,Kent Bazemore,1610612737,ATL,75,44,31,2083.0,28,14,13,0.5,134,0.209,6,0.219,9.5,351,52,298,0.148,568,0.618,34,0.657,6.3,379,66,311,0.174,702,0.54,40,0.573,6.5
263,203484,Kentavious Caldwell-Pope,1610612765,DET,76,41,35,2789.0,70,32,34,0.457,189,0.37,4,0.378,10.9,212,39,174,0.184,355,0.597,25,0.642,9.0,282,71,208,0.252,544,0.518,29,0.548,9.5
264,201142,Kevin Durant,1610612760,OKC,72,52,20,2578.0,45,21,22,0.467,140,0.321,4,0.331,13.8,544,108,434,0.199,724,0.751,28,0.782,6.3,589,129,456,0.219,864,0.682,32,0.708,6.9
265,708,Kevin Garnett,1610612750,MIN,38,14,24,556.0,15,8,7,0.533,38,0.395,0,0.395,12.4,135,31,102,0.23,215,0.628,11,0.662,4.8,150,39,109,0.26,253,0.593,11,0.62,5.6
266,201567,Kevin Love,1610612739,CLE,77,53,24,2424.0,149,97,45,0.651,338,0.441,9,0.453,7.4,613,187,419,0.305,943,0.65,78,0.709,4.3,762,284,464,0.373,1281,0.595,87,0.638,4.9
267,2755,Kevin Martin,1610612759,SAS,55,24,31,1095.0,14,4,11,0.286,67,0.209,2,0.215,13.8,96,17,78,0.177,154,0.623,10,0.667,7.4,110,21,89,0.191,221,0.498,12,0.526,8.2
268,202338,Kevin Seraphin,1610612752,NYK,48,15,33,526.0,31,20,11,0.645,84,0.369,2,0.378,5.7,95,39,54,0.411,178,0.534,22,0.609,3.9,126,59,65,0.468,262,0.481,24,0.529,4.4
269,1626172,Kevon Looney,1610612744,GSW,5,4,1,21.0,4,2,2,0.5,6,0.667,0,0.667,9.1,6,3,3,0.5,7,0.857,0,0.857,8.2,10,5,5,0.5,13,0.769,0,0.769,8.5
270,203114,Khris Middleton,1610612749,MIL,79,33,46,2852.0,44,18,28,0.409,157,0.28,6,0.291,12.7,258,50,211,0.194,437,0.59,26,0.628,8.7,302,68,239,0.225,594,0.508,32,0.537,9.4
271,2550,Kirk Hinrich,1610612737,ATL,46,26,20,631.0,8,2,6,0.25,42,0.19,1,0.195,18.4,62,8,56,0.129,131,0.473,13,0.525,11.3,70,10,62,0.143,173,0.405,14,0.44,12.1
272,202691,Klay Thompson,1610612744,GSW,80,71,9,2666.0,35,13,22,0.371,147,0.238,7,0.25,13.6,271,67,204,0.247,541,0.501,57,0.56,7.5,306,80,226,0.261,688,0.445,64,0.49,8.3
273,977,Kobe Bryant,1610612747,LAL,66,13,53,1863.0,41,16,24,0.39,158,0.259,6,0.27,13.4,206,21,188,0.102,319,0.646,21,0.691,7.5,247,37,212,0.15,477,0.518,27,0.549,8.4
274,201585,Kosta Koufos,1610612758,SAC,77,32,45,1463.0,167,97,70,0.581,342,0.488,6,0.497,6.2,246,77,170,0.313,424,0.58,41,0.642,4.8,413,174,240,0.421,766,0.539,47,0.574,5.4
275,203123,Kostas Papanikolaou,1610612743,DEN,26,8,18,294.0,8,3,4,0.375,42,0.19,0,0.19,9.4,32,9,24,0.281,65,0.492,3,0.516,6.3,40,12,28,0.3,107,0.374,3,0.385,6.9
276,2743,Kris Humphries,1610612737,ATL,53,29,24,835.0,57,39,16,0.684,155,0.368,1,0.37,5.7,161,54,107,0.335,297,0.542,27,0.596,4.1,218,93,123,0.427,452,0.482,28,0.514,4.5
277,204001,Kristaps Porzingis,1610612752,NYK,72,28,44,2047.0,132,86,45,0.652,265,0.498,5,0.508,7.6,394,130,257,0.33,647,0.609,55,0.666,4.8,526,216,302,0.411,912,0.577,60,0.617,5.5
278,203937,Kyle Anderson,1610612759,SAS,78,64,14,1245.0,25,11,13,0.44,78,0.321,1,0.325,9.9,219,56,161,0.256,332,0.66,23,0.709,6.3,244,67,174,0.275,410,0.595,24,0.632,6.6
279,2594,Kyle Korver,1610612737,ATL,80,46,34,2401.0,14,3,10,0.214,83,0.169,3,0.175,19.0,246,59,184,0.24,546,0.451,58,0.504,7.0,260,62,194,0.238,629,0.413,61,0.458,7.6
280,200768,Kyle Lowry,1610612761,TOR,76,53,23,2804.0,54,28,27,0.519,291,0.186,7,0.19,9.1,303,66,239,0.218,599,0.506,53,0.555,8.4,357,94,266,0.263,890,0.401,60,0.43,8.5
281,203124,Kyle O'Quinn,1610612752,NYK,65,26,39,764.0,76,55,20,0.724,152,0.5,5,0.517,6.4,174,83,91,0.477,289,0.602,29,0.669,4.1,250,138,111,0.552,441,0.567,34,0.614,4.8
282,202713,Kyle Singler,1610612760,OKC,68,43,25,977.0,50,24,26,0.48,129,0.388,3,0.397,9.1,91,24,65,0.264,185,0.492,17,0.542,7.0,141,48,91,0.34,314,0.449,20,0.48,7.7
283,202681,Kyrie Irving,1610612739,CLE,53,37,16,1667.0,44,20,21,0.455,149,0.295,6,0.308,12.6,113,14,98,0.124,239,0.473,25,0.528,8.7,157,34,119,0.217,388,0.405,31,0.44,9.7
284,200746,LaMarcus Aldridge,1610612759,SAS,74,61,13,2261.0,176,127,46,0.722,366,0.481,8,0.492,5.0,456,138,312,0.303,632,0.722,43,0.774,5.2,632,265,358,0.419,998,0.633,51,0.667,5.2
285,203934,Lamar Patterson,1610612737,ATL,35,23,12,395.0,4,2,3,0.5,20,0.2,0,0.2,7.2,46,11,36,0.239,79,0.582,5,0.622,6.1,50,13,39,0.26,99,0.505,5,0.532,6.4
286,202362,Lance Stephenson,1610612763,MEM,69,36,33,1372.0,40,18,20,0.45,130,0.308,6,0.323,6.9,183,40,144,0.219,286,0.64,18,0.683,6.6,223,58,164,0.26,416,0.536,24,0.569,6.7
287,202498,Lance Thomas,1610612752,NYK,59,25,34,1313.0,34,15,21,0.441,119,0.286,3,0.293,11.7,97,31,66,0.32,227,0.427,18,0.464,6.8,131,46,87,0.351,346,0.379,21,0.403,8.2
288,204038,Langston Galloway,1610612752,NYK,82,32,50,2033.0,43,18,27,0.419,144,0.299,8,0.316,13.4,245,35,210,0.143,428,0.572,35,0.623,8.5,288,53,237,0.184,572,0.503,43,0.544,9.3
289,1626204,Larry Nance Jr.,1610612747,LAL,63,14,49,1266.0,101,59,43,0.584,231,0.437,10,0.457,8.1,211,57,155,0.27,391,0.54,29,0.583,5.4,312,116,198,0.372,622,0.502,39,0.535,6.2
290,202730,Lavoy Allen,1610612754,IND,79,43,36,1599.0,162,114,47,0.704,373,0.434,8,0.444,5.6,262,100,159,0.382,449,0.584,33,0.63,5.2,424,214,206,0.505,822,0.516,41,0.543,5.3
291,2544,LeBron James,1610612739,CLE,76,56,20,2709.0,111,67,40,0.604,306,0.363,11,0.376,7.0,454,109,341,0.24,617,0.736,32,0.776,6.8,565,176,381,0.312,923,0.612,43,0.642,6.9
292,2571,Leandro Barbosa,1610612744,GSW,68,60,8,1079.0,28,11,20,0.393,93,0.301,5,0.318,14.7,89,11,77,0.124,162,0.549,10,0.586,9.4,117,22,97,0.188,255,0.459,15,0.488,10.7
293,203485,Lorenzo Brown,1610612765,DET,8,1,7,61.0,0,0,0,0.0,4,0.0,0,0.0,0.0,7,1,7,0.143,15,0.467,0,0.467,5.6,7,1,7,0.143,19,0.368,0,0.368,5.6
294,200811,Lou Amundson,1610612752,NYK,29,11,18,204.0,23,16,6,0.696,55,0.418,1,0.426,9.6,26,11,16,0.423,58,0.448,6,0.5,4.3,49,27,22,0.551,113,0.434,7,0.462,6.7
295,101150,Lou Williams,1610612747,LAL,67,14,53,1907.0,31,11,17,0.355,105,0.295,2,0.301,16.8,138,21,118,0.152,242,0.57,20,0.622,9.4,169,32,135,0.189,347,0.487,22,0.52,10.7
296,201601,Luc Mbah a Moute,1610612746,LAC,75,49,26,1274.0,60,32,28,0.533,138,0.435,3,0.444,8.4,111,29,79,0.261,258,0.43,27,0.481,7.9,171,61,107,0.357,396,0.432,30,0.467,8.1
297,203512,Lucas Nogueira,1610612761,TOR,29,17,12,225.0,18,13,5,0.722,39,0.462,0,0.462,5.4,28,13,15,0.464,55,0.509,5,0.56,4.5,46,26,20,0.565,94,0.489,5,0.517,4.8
298,1626242,Luis Montero,1610612757,POR,12,6,6,42.0,0,0,0,0.0,4,0.0,0,0.0,0.0,4,1,3,0.25,7,0.571,0,0.571,13.5,4,1,3,0.25,11,0.364,0,0.364,13.5
299,2449,Luis Scola,1610612761,TOR,75,49,26,1617.0,83,47,33,0.566,227,0.366,3,0.371,6.7,275,94,179,0.342,477,0.577,38,0.626,4.5,358,141,212,0.394,704,0.509,41,0.54,5.0
300,202337,Luke Babbitt,1610612740,NOP,47,16,31,845.0,25,13,11,0.52,78,0.321,1,0.325,8.3,123,18,102,0.146,189,0.651,13,0.699,5.5,148,31,113,0.209,267,0.554,14,0.585,6.0
301,2736,Luol Deng,1610612748,MIA,74,45,29,2394.0,108,67,40,0.62,254,0.425,9,0.441,6.5,335,91,238,0.272,597,0.561,54,0.617,7.1,443,158,278,0.357,851,0.521,63,0.562,7.0
302,1938,Manu Ginobili,1610612759,SAS,58,47,11,1134.0,26,15,12,0.577,87,0.299,2,0.306,9.4,120,27,92,0.225,207,0.58,14,0.622,8.7,146,42,104,0.288,294,0.497,16,0.525,8.9
303,201188,Marc Gasol,1610612763,MEM,52,30,22,1791.0,58,33,25,0.569,148,0.392,3,0.4,7.4,304,126,175,0.414,505,0.602,38,0.651,5.2,362,159,200,0.439,653,0.554,41,0.592,5.6
304,1626273,Marcelo Huertas,1610612747,LAL,53,8,45,869.0,18,5,13,0.278,66,0.273,3,0.286,15.1,72,3,67,0.042,144,0.5,6,0.522,11.0,90,8,80,0.089,210,0.429,9,0.448,11.8
305,101162,Marcin Gortat,1610612764,WAS,75,35,40,2256.0,222,140,79,0.631,487,0.456,14,0.469,6.6,519,148,366,0.285,877,0.592,87,0.657,4.3,741,288,445,0.389,1364,0.543,101,0.587,5.0
306,201158,Marco Belinelli,1610612758,SAC,67,27,40,1646.0,10,2,8,0.2,58,0.172,1,0.175,19.1,104,14,90,0.135,218,0.477,27,0.545,7.7,114,16,98,0.14,276,0.413,28,0.46,8.7
307,202694,Marcus Morris,1610612765,DET,80,42,38,2856.0,91,49,36,0.538,273,0.333,4,0.338,9.1,313,76,234,0.243,537,0.583,42,0.632,6.4,404,125,270,0.309,810,0.499,46,0.529,7.0
308,203935,Marcus Smart,1610612738,BOS,61,36,25,1667.0,76,47,29,0.618,219,0.347,8,0.36,7.5,179,47,133,0.263,302,0.593,27,0.651,7.4,255,94,162,0.369,521,0.489,35,0.525,7.4
309,201977,Marcus Thornton,1610612764,WAS,61,32,29,1108.0,38,18,21,0.474,130,0.292,6,0.306,9.6,112,14,97,0.125,204,0.549,24,0.622,8.1,150,32,118,0.213,334,0.449,30,0.493,8.5
310,201596,Mario Chalmers,1610612748,MIA,61,38,23,1373.0,24,11,16,0.458,91,0.264,3,0.273,7.5,133,18,116,0.135,247,0.538,17,0.578,8.6,157,29,132,0.185,338,0.464,20,0.494,8.6
311,1626209,Mario Hezonja,1610612753,ORL,78,33,45,1399.0,28,16,12,0.571,90,0.311,1,0.315,7.5,146,28,120,0.192,252,0.579,24,0.64,5.9,174,44,132,0.253,342,0.509,25,0.549,6.2
312,203900,Markel Brown,1610612751,BKN,62,12,50,982.0,23,7,14,0.304,91,0.253,4,0.264,9.7,99,18,81,0.182,182,0.544,18,0.604,7.3,122,25,95,0.205,273,0.447,22,0.486,7.7
313,202693,Markieff Morris,1610612764,WAS,64,22,42,1629.0,73,39,31,0.534,180,0.406,7,0.422,8.2,279,103,174,0.369,408,0.684,32,0.742,5.7,352,142,205,0.403,588,0.599,39,0.641,6.2
314,201578,Marreese Speights,1610612744,GSW,72,64,8,832.0,77,51,23,0.662,183,0.421,3,0.428,5.4,162,73,87,0.451,289,0.561,20,0.602,4.6,239,124,110,0.519,472,0.506,23,0.532,4.9
315,101107,Marvin Williams,1610612766,CHA,81,47,34,2338.0,127,79,42,0.622,247,0.514,5,0.525,7.5,394,104,288,0.264,665,0.592,43,0.633,5.6,521,183,330,0.351,912,0.571,48,0.603,6.0
316,203486,Mason Plumlee,1610612757,POR,82,44,38,2084.0,201,135,62,0.672,495,0.406,10,0.414,6.9,427,145,279,0.34,760,0.562,67,0.616,4.4,628,280,341,0.446,1255,0.5,77,0.533,5.2
317,2440,Matt Barnes,1610612763,MEM,76,38,38,2190.0,84,47,31,0.56,233,0.361,10,0.377,7.4,336,67,261,0.199,509,0.66,29,0.7,6.1,420,114,292,0.271,742,0.566,39,0.597,6.3
318,2588,Matt Bonner,1610612759,SAS,30,25,5,206.0,3,1,2,0.333,12,0.25,0,0.25,12.8,24,6,18,0.25,45,0.533,6,0.615,5.8,27,7,20,0.259,57,0.474,6,0.529,6.6
319,203521,Matthew Dellavedova,1610612739,CLE,76,54,22,1867.0,33,12,21,0.364,115,0.287,3,0.295,15.3,129,23,109,0.178,293,0.44,30,0.49,10.0,162,35,130,0.216,408,0.397,33,0.432,11.1
320,203090,Maurice Harkless,1610612757,POR,78,40,38,1457.0,101,59,39,0.584,228,0.443,4,0.451,7.8,179,56,122,0.313,320,0.559,27,0.611,5.5,280,115,161,0.411,548,0.511,31,0.542,6.3
321,1897,Metta World Peace,1610612747,LAL,35,6,29,590.0,19,13,6,0.684,74,0.257,2,0.264,7.4,70,10,61,0.143,132,0.53,10,0.574,7.9,89,23,67,0.258,206,0.432,12,0.459,7.8
322,203086,Meyers Leonard,1610612757,POR,61,33,28,1333.0,51,32,21,0.627,124,0.411,4,0.425,6.5,263,82,177,0.312,414,0.635,24,0.674,4.2,314,114,198,0.363,538,0.584,28,0.616,4.6
323,201563,Michael Beasley,1610612745,HOU,20,10,10,363.0,29,21,8,0.724,72,0.403,1,0.408,4.7,69,30,39,0.435,114,0.605,9,0.657,4.5,98,51,47,0.52,186,0.527,10,0.557,4.6
324,203487,Michael Carter-Williams,1610612749,MIL,54,21,33,1649.0,48,35,15,0.729,172,0.279,6,0.289,6.9,228,59,170,0.259,399,0.571,35,0.626,7.2,276,94,185,0.341,571,0.483,41,0.521,7.2
325,203077,Michael Kidd-Gilchrist,1610612766,CHA,7,5,2,205.0,12,10,1,0.833,38,0.316,2,0.333,5.9,33,11,22,0.333,55,0.6,6,0.673,5.1,45,21,23,0.467,93,0.484,8,0.529,5.3
326,201144,Mike Conley,1610612763,MEM,56,33,23,1760.0,26,8,18,0.308,109,0.239,4,0.248,13.3,138,20,123,0.145,289,0.478,27,0.527,9.6,164,28,141,0.171,398,0.412,31,0.447,10.1
327,2399,Mike Dunleavy,1610612741,CHI,31,13,18,703.0,8,6,1,0.75,48,0.167,1,0.17,4.0,75,16,61,0.213,160,0.469,23,0.547,6.1,83,22,62,0.265,208,0.399,24,0.451,5.9
328,2034,Mike Miller,1610612743,DEN,47,21,26,373.0,6,1,4,0.167,15,0.4,1,0.429,12.6,47,7,40,0.149,85,0.553,5,0.588,6.0,53,8,44,0.151,100,0.53,6,0.564,6.6
329,203488,Mike Muscala,1610612737,ATL,60,34,26,565.0,38,25,12,0.658,92,0.413,1,0.418,4.3,79,32,43,0.405,188,0.42,18,0.465,4.6,117,57,55,0.487,280,0.418,19,0.448,4.5
330,203118,Mike Scott,1610612737,ATL,75,46,29,1146.0,53,36,17,0.679,145,0.366,1,0.368,6.1,153,43,111,0.281,301,0.508,23,0.55,6.7,206,79,128,0.383,446,0.462,24,0.488,6.6
331,203101,Miles Plumlee,1610612749,MIL,61,23,38,870.0,94,53,39,0.564,190,0.495,8,0.516,6.0,138,47,89,0.341,273,0.505,25,0.556,4.9,232,100,128,0.431,463,0.501,33,0.54,5.3
332,203141,Mirza Teletovic,1610612756,PHX,79,23,56,1685.0,55,32,22,0.582,167,0.329,7,0.344,8.3,247,84,165,0.34,449,0.55,39,0.602,4.8,302,116,187,0.384,616,0.49,46,0.53,5.4
333,203956,Mitch McGary,1610612760,OKC,20,17,3,72.0,4,2,1,0.5,13,0.308,0,0.308,6.0,14,2,11,0.143,24,0.583,3,0.667,5.5,18,4,12,0.222,37,0.486,3,0.529,5.6
334,2590,Mo Williams,1610612739,CLE,41,27,14,748.0,6,1,7,0.167,43,0.14,3,0.15,10.7,66,4,65,0.061,132,0.5,11,0.545,10.9,72,5,72,0.069,175,0.411,14,0.447,11.3
335,101145,Monta Ellis,1610612754,IND,81,44,37,2734.0,42,18,27,0.429,172,0.244,7,0.255,15.3,229,23,205,0.1,423,0.541,27,0.578,8.8,271,41,232,0.151,595,0.455,34,0.483,10.0
336,1626149,Montrezl Harrell,1610612745,HOU,39,17,22,379.0,25,11,12,0.44,54,0.463,0,0.463,7.2,40,16,23,0.4,74,0.541,2,0.556,6.3,65,27,35,0.415,128,0.508,2,0.516,6.7
337,1626167,Myles Turner,1610612754,IND,60,32,28,1367.0,68,46,20,0.676,189,0.36,4,0.368,6.7,264,114,150,0.432,514,0.514,42,0.559,4.5,332,160,170,0.482,703,0.472,46,0.505,5.0
338,101126,Nate Robinson,1610612740,NOP,2,0,2,23.0,0,0,0,0.0,0,0.0,0,0.0,0.0,0,0,0,0.0,5,0.0,1,0.0,0.0,0,0,0,0.0,5,0.0,1,0.0,0.0
339,1737,Nazr Mohammed,1610612760,OKC,5,5,0,19.0,1,1,0,1.0,2,0.5,0,0.5,2.7,3,2,1,0.667,5,0.6,1,0.75,3.4,4,3,1,0.75,7,0.571,1,0.667,3.2
340,202357,Nemanja Bjelica,1610612750,MIN,60,20,40,1075.0,49,36,12,0.735,111,0.441,3,0.454,7.7,161,54,108,0.335,305,0.528,27,0.579,4.8,210,90,120,0.429,416,0.505,30,0.544,5.5
341,2403,Nene,1610612764,WAS,57,28,29,1094.0,52,38,14,0.731,155,0.335,2,0.34,7.3,207,72,134,0.348,352,0.588,43,0.67,5.0,259,110,148,0.425,507,0.511,45,0.561,5.4
342,203457,Nerlens Noel,1610612755,PHI,67,10,57,1965.0,154,103,48,0.669,380,0.405,14,0.421,6.4,388,129,256,0.332,683,0.568,64,0.627,4.0,542,232,304,0.428,1063,0.51,78,0.55,4.6
343,2555,Nick Collison,1610612760,OKC,59,39,20,699.0,68,52,16,0.765,150,0.453,3,0.463,6.1,103,34,68,0.33,186,0.554,19,0.617,5.1,171,86,84,0.503,336,0.509,22,0.545,5.5
344,201156,Nick Young,1610612747,LAL,54,13,41,1033.0,14,3,11,0.214,66,0.212,1,0.215,15.8,83,23,60,0.277,184,0.451,12,0.483,7.2,97,26,71,0.268,250,0.388,13,0.409,8.4
345,201587,Nicolas Batum,1610612766,CHA,70,41,29,2448.0,55,25,30,0.455,202,0.272,7,0.282,11.8,373,65,308,0.174,567,0.658,30,0.695,6.4,428,90,338,0.21,769,0.557,37,0.585,7.1
346,203917,Nik Stauskas,1610612755,PHI,73,8,65,1809.0,23,8,14,0.348,108,0.213,4,0.221,12.9,160,21,137,0.131,293,0.546,23,0.593,7.4,183,29,151,0.158,401,0.456,27,0.489,8.1
347,203999,Nikola Jokic,1610612743,DEN,80,31,49,1733.0,181,127,49,0.702,422,0.429,8,0.437,5.5,379,153,225,0.404,642,0.59,57,0.648,4.3,560,280,274,0.5,1064,0.526,65,0.561,4.7
348,202703,Nikola Mirotic,1610612741,CHI,66,37,29,1646.0,58,33,26,0.569,156,0.372,1,0.374,7.1,304,73,228,0.24,511,0.595,40,0.645,5.0,362,106,254,0.293,667,0.543,41,0.578,5.4
349,201593,Nikola Pekovic,1610612750,MIN,12,2,10,156.0,7,6,1,0.857,23,0.304,2,0.333,3.7,14,5,8,0.357,32,0.438,7,0.56,5.6,21,11,9,0.524,55,0.382,9,0.457,4.9
350,202696,Nikola Vucevic,1610612753,ORL,64,28,36,1998.0,172,100,65,0.581,347,0.496,11,0.512,6.5,393,166,229,0.422,635,0.619,53,0.675,4.3,565,266,294,0.471,982,0.575,64,0.615,4.9
351,203943,Noah Vonleh,1610612757,POR,78,41,37,1174.0,91,62,28,0.681,231,0.394,8,0.408,6.0,214,77,135,0.36,359,0.596,38,0.667,4.5,305,139,163,0.456,590,0.517,46,0.561,4.9
352,1626181,Norman Powell,1610612761,TOR,48,31,17,722.0,16,5,11,0.313,58,0.276,3,0.291,16.6,94,16,78,0.17,157,0.599,13,0.653,8.0,110,21,89,0.191,215,0.512,16,0.553,9.3
353,202708,Norris Cole,1610612740,NOP,45,20,25,1198.0,10,1,9,0.1,62,0.161,2,0.167,17.7,141,23,118,0.163,223,0.632,23,0.705,9.3,151,24,127,0.159,285,0.53,25,0.581,9.9
354,201564,O.J. Mayo,1610612749,MIL,41,17,24,1090.0,13,3,9,0.231,58,0.224,1,0.228,13.7,92,15,78,0.163,190,0.484,17,0.532,8.7,105,18,87,0.171,248,0.423,18,0.457,9.3
355,201600,Omer Asik,1610612740,NOP,68,29,39,1178.0,120,83,30,0.692,270,0.444,2,0.448,5.5,294,98,195,0.333,476,0.618,46,0.684,4.1,414,181,225,0.437,746,0.555,48,0.593,4.5
356,201956,Omri Casspi,1610612758,SAC,69,27,42,1880.0,58,28,29,0.483,203,0.286,8,0.297,8.0,352,70,283,0.199,609,0.578,53,0.633,4.8,410,98,312,0.239,812,0.505,61,0.546,5.2
357,203111,Orlando Johnson,1610612740,NOP,7,1,6,102.0,4,2,3,0.5,12,0.333,0,0.333,7.1,11,1,10,0.091,30,0.367,3,0.407,6.9,15,3,13,0.2,42,0.357,3,0.385,7.0
358,203490,Otto Porter Jr.,1610612764,WAS,75,36,39,2276.0,97,55,41,0.567,286,0.339,9,0.35,8.1,294,81,212,0.276,501,0.587,33,0.628,5.4,391,136,253,0.348,787,0.497,42,0.525,6.0
359,203798,PJ Hairston,1610612763,MEM,66,31,35,1313.0,25,11,15,0.44,98,0.255,2,0.26,11.2,149,27,121,0.181,265,0.562,19,0.606,6.9,174,38,136,0.218,363,0.479,21,0.509,7.5
360,200782,PJ Tucker,1610612756,PHX,82,23,59,2540.0,165,102,56,0.618,426,0.387,17,0.403,7.2,347,90,255,0.259,486,0.714,40,0.778,6.3,512,192,311,0.375,912,0.561,57,0.599,6.6
361,203143,Pablo Prigioni,1610612746,LAC,59,37,22,823.0,38,13,26,0.342,100,0.38,2,0.388,13.8,76,11,66,0.145,147,0.517,9,0.551,8.6,114,24,92,0.211,247,0.462,11,0.483,10.3
362,1626192,Pat Connaughton,1610612757,POR,34,17,17,143.0,11,3,7,0.273,17,0.647,0,0.647,8.1,21,7,15,0.333,40,0.525,1,0.538,5.9,32,10,22,0.313,57,0.561,1,0.571,6.6
363,201976,Patrick Beverley,1610612745,HOU,71,35,36,2041.0,73,39,33,0.534,199,0.367,6,0.378,9.7,177,28,146,0.158,341,0.519,29,0.567,8.8,250,67,179,0.268,540,0.463,35,0.495,9.1
364,202335,Patrick Patterson,1610612761,TOR,78,53,25,1984.0,76,46,27,0.605,144,0.528,3,0.539,8.5,259,86,171,0.332,487,0.532,27,0.563,6.2,335,132,198,0.394,631,0.531,30,0.557,6.7
365,201988,Patty Mills,1610612759,SAS,81,66,15,1662.0,27,4,23,0.148,91,0.297,4,0.31,15.5,131,10,121,0.076,237,0.553,16,0.593,10.1,158,14,144,0.089,328,0.482,20,0.513,11.1
366,2200,Pau Gasol,1610612741,CHI,72,36,36,2291.0,155,108,45,0.697,336,0.461,10,0.475,6.1,638,231,400,0.362,1035,0.616,85,0.672,4.4,793,339,445,0.427,1371,0.578,95,0.621,4.7
367,202331,Paul George,1610612754,IND,81,44,37,2819.0,79,39,41,0.494,261,0.303,4,0.307,11.2,484,90,395,0.186,773,0.626,60,0.679,6.3,563,129,436,0.229,1034,0.544,64,0.58,7.0
368,200794,Paul Millsap,1610612737,ATL,81,48,33,2647.0,198,139,60,0.702,452,0.438,9,0.447,7.3,534,182,351,0.341,942,0.567,78,0.618,4.9,732,321,411,0.439,1394,0.525,87,0.56,5.5
369,1718,Paul Pierce,1610612746,LAC,68,44,24,1231.0,12,3,9,0.25,55,0.218,3,0.231,16.6,174,57,112,0.328,353,0.493,33,0.544,5.5,186,60,121,0.323,408,0.456,36,0.5,6.3
370,203515,Phil Pressey,1610612757,POR,23,3,20,283.0,3,0,3,0.0,21,0.143,2,0.158,19.9,28,2,26,0.071,48,0.583,2,0.609,11.3,31,2,29,0.065,69,0.449,4,0.477,12.2
371,203112,Quincy Acy,1610612758,SAC,58,21,37,869.0,64,40,21,0.625,158,0.405,7,0.424,5.7,123,32,89,0.26,224,0.549,22,0.609,4.4,187,72,110,0.385,382,0.49,29,0.53,4.9
372,1626154,RJ Hunter,1610612738,BOS,35,20,15,307.0,2,0,2,0.0,8,0.25,0,0.25,15.6,34,6,28,0.176,50,0.68,1,0.694,8.1,36,6,30,0.167,58,0.621,1,0.632,8.5
373,200765,Rajon Rondo,1610612758,SAC,71,29,42,2513.0,77,30,43,0.39,282,0.273,10,0.283,12.0,355,38,315,0.107,628,0.565,50,0.614,8.7,432,68,358,0.157,910,0.475,60,0.508,9.2
374,1626176,Rakeem Christmas,1610612754,IND,1,1,0,6.0,1,0,1,0.0,1,1.0,0,1.0,6.5,0,0,0,0.0,1,0.0,0,0.0,0.0,1,0,1,0.0,2,0.5,0,0.5,6.5
375,201196,Ramon Sessions,1610612764,WAS,82,41,41,1667.0,25,6,19,0.24,124,0.202,3,0.207,16.0,178,19,158,0.107,276,0.645,16,0.685,9.2,203,25,177,0.123,400,0.508,19,0.533,10.0
376,200751,Randy Foye,1610612760,OKC,81,37,44,1641.0,24,4,18,0.167,106,0.226,3,0.233,19.2,132,28,104,0.212,258,0.512,21,0.557,8.9,156,32,122,0.205,364,0.429,24,0.459,10.3
377,1626173,Rashad Vaughn,1610612749,MIL,70,30,40,1001.0,11,6,6,0.545,58,0.19,1,0.193,9.8,77,19,58,0.247,165,0.467,11,0.5,6.3,88,25,64,0.284,223,0.395,12,0.417,6.8
378,2446,Rasual Butler,1610612759,SAS,46,41,5,431.0,3,2,1,0.667,20,0.15,2,0.167,12.0,53,13,40,0.245,97,0.546,10,0.609,6.7,56,15,41,0.268,117,0.479,12,0.533,7.0
379,203526,Raul Neto,1610612762,UTA,81,40,41,1499.0,17,4,13,0.235,82,0.207,2,0.213,20.2,103,14,90,0.136,213,0.484,11,0.51,10.5,120,18,103,0.15,295,0.407,13,0.426,11.9
380,203492,Ray McCallum,1610612759,SAS,41,30,11,474.0,8,2,6,0.25,37,0.216,1,0.222,13.3,39,7,30,0.179,87,0.448,6,0.481,9.8,47,9,36,0.191,124,0.379,7,0.402,10.4
381,101109,Raymond Felton,1610612742,DAL,80,40,40,2192.0,36,18,18,0.5,135,0.267,11,0.29,11.7,222,30,192,0.135,420,0.529,33,0.574,7.8,258,48,210,0.186,555,0.465,44,0.505,8.4
382,203493,Reggie Bullock,1610612765,DET,37,22,15,429.0,14,5,8,0.357,44,0.318,2,0.333,10.7,54,7,45,0.13,93,0.581,14,0.684,5.7,68,12,53,0.176,137,0.496,16,0.562,6.7
383,202704,Reggie Jackson,1610612765,DET,79,43,36,2424.0,58,28,32,0.483,205,0.283,8,0.294,10.9,195,22,172,0.113,403,0.484,39,0.536,8.9,253,50,204,0.198,608,0.416,47,0.451,9.4
384,2210,Richard Jefferson,1610612739,CLE,74,51,23,1326.0,15,7,8,0.467,97,0.155,2,0.158,12.7,113,24,88,0.212,243,0.465,26,0.521,6.2,128,31,96,0.242,340,0.376,28,0.41,7.0
385,1626158,Richaun Holmes,1610612755,PHI,51,7,44,702.0,62,47,14,0.758,156,0.397,5,0.411,5.4,73,34,39,0.466,189,0.386,20,0.432,5.0,135,81,53,0.6,345,0.391,25,0.422,5.2
386,201937,Ricky Rubio,1610612750,MIN,76,28,48,2323.0,40,7,33,0.175,150,0.267,10,0.286,15.3,286,47,237,0.164,492,0.581,43,0.637,9.5,326,54,270,0.166,642,0.508,53,0.553,10.2
387,203496,Robert Covington,1610612755,PHI,67,10,57,1903.0,65,42,22,0.646,202,0.322,3,0.327,8.8,354,108,242,0.305,555,0.638,43,0.691,4.8,419,150,264,0.358,757,0.554,46,0.589,5.4
388,203135,Robert Sacre,1610612747,LAL,25,2,23,320.0,32,19,12,0.594,82,0.39,2,0.4,5.9,40,19,23,0.475,82,0.488,14,0.588,5.8,72,38,35,0.528,164,0.439,16,0.486,5.8
389,201577,Robin Lopez,1610612752,NYK,82,32,50,2219.0,268,204,56,0.761,546,0.491,9,0.499,4.7,334,146,185,0.437,673,0.496,61,0.546,5.2,602,350,241,0.581,1219,0.494,70,0.524,5.0
390,203918,Rodney Hood,1610612762,UTA,79,39,40,2541.0,38,13,25,0.342,151,0.252,6,0.262,12.8,229,36,193,0.157,430,0.533,42,0.59,8.4,267,49,218,0.184,581,0.46,48,0.501,9.1
391,201155,Rodney Stuckey,1610612754,IND,58,33,25,1275.0,19,6,13,0.316,84,0.226,2,0.232,14.4,137,31,107,0.226,227,0.604,11,0.634,8.3,156,37,120,0.237,311,0.502,13,0.523,9.1
392,1626178,Rondae Hollis-Jefferson,1610612751,BKN,29,7,22,615.0,39,22,15,0.564,87,0.448,2,0.459,8.4,115,35,81,0.304,190,0.605,17,0.665,5.6,154,57,96,0.37,277,0.556,19,0.597,6.2
393,101179,Ronnie Price,1610612756,PHX,62,20,42,1211.0,25,9,16,0.36,95,0.263,3,0.272,13.9,74,6,70,0.081,136,0.544,10,0.587,11.7,99,15,86,0.152,231,0.429,13,0.454,12.2
394,201579,Roy Hibbert,1610612747,LAL,81,17,64,1878.0,132,88,40,0.667,351,0.376,13,0.391,4.8,266,93,172,0.35,545,0.488,55,0.543,5.3,398,181,212,0.455,896,0.444,68,0.481,5.1
395,200752,Rudy Gay,1610612758,SAC,69,29,40,2348.0,103,65,31,0.631,302,0.341,11,0.354,6.0,346,96,254,0.277,528,0.655,30,0.695,6.2,449,161,285,0.359,830,0.541,41,0.569,6.2
396,203497,Rudy Gobert,1610612762,UTA,61,33,28,1932.0,208,153,55,0.736,475,0.438,11,0.448,5.1,460,148,310,0.322,747,0.616,54,0.664,3.8,668,301,365,0.451,1222,0.547,65,0.577,4.2
397,203893,Russ Smith,1610612763,MEM,15,6,9,66.0,1,0,1,0.0,8,0.125,1,0.143,17.9,8,0,7,0.0,10,0.8,0,0.8,11.6,9,0,8,0.0,18,0.5,1,0.529,12.4
398,201566,Russell Westbrook,1610612760,OKC,80,55,25,2749.0,145,74,68,0.51,422,0.344,11,0.353,8.7,481,81,401,0.168,739,0.651,42,0.69,7.3,626,155,469,0.248,1161,0.539,53,0.565,7.6
399,201583,Ryan Anderson,1610612740,NOP,66,24,42,2008.0,131,95,31,0.725,316,0.415,3,0.419,4.6,265,108,161,0.408,480,0.552,46,0.611,5.2,396,203,192,0.513,796,0.497,49,0.53,5.0
400,200797,Ryan Hollins,1610612763,MEM,37,18,19,460.0,47,29,16,0.617,121,0.388,5,0.405,6.9,51,20,31,0.392,137,0.372,17,0.425,4.8,98,49,47,0.5,258,0.38,22,0.415,5.8
401,203527,Ryan Kelly,1610612747,LAL,36,3,33,470.0,21,7,14,0.333,59,0.356,4,0.382,8.6,100,29,69,0.29,140,0.714,8,0.758,4.8,121,36,83,0.298,199,0.608,12,0.647,5.5
402,1626257,Salah Mejri,1610612742,DAL,34,16,18,397.0,41,23,14,0.561,82,0.5,1,0.506,6.8,82,36,46,0.439,149,0.55,11,0.594,4.7,123,59,60,0.48,231,0.532,12,0.562,5.4
403,1626155,Sam Dekker,1610612745,HOU,3,1,2,6.0,0,0,0,0.0,0,0.0,0,0.0,0.0,1,0,1,0.0,1,1.0,0,1.0,13.8,1,0,1,0.0,1,1.0,0,1.0,13.8
404,201619,Sasha Kaun,1610612739,CLE,25,18,7,95.0,12,8,3,0.667,31,0.387,0,0.387,5.5,14,4,10,0.286,29,0.483,2,0.519,7.7,26,12,13,0.462,60,0.433,2,0.448,6.7
405,2756,Sasha Vujacic,1610612752,NYK,61,22,39,908.0,26,11,16,0.423,72,0.361,4,0.382,15.8,123,18,105,0.146,221,0.557,21,0.615,8.4,149,29,121,0.195,293,0.509,25,0.556,9.7
406,203930,Sean Kilpatrick,1610612751,BKN,31,7,24,616.0,12,4,7,0.333,56,0.214,0,0.214,11.1,44,3,42,0.068,80,0.55,8,0.611,7.7,56,7,49,0.125,136,0.412,8,0.438,8.4
407,201586,Serge Ibaka,1610612760,OKC,78,54,24,2500.0,141,84,52,0.596,298,0.473,11,0.491,7.6,392,118,270,0.301,741,0.529,69,0.583,4.8,533,202,322,0.379,1039,0.513,80,0.556,5.5
408,203508,Sergey Karasev,1610612751,BKN,40,9,31,399.0,8,3,4,0.375,30,0.267,0,0.267,5.6,50,15,35,0.3,91,0.549,9,0.61,7.0,58,18,39,0.31,121,0.479,9,0.518,6.9
409,203552,Seth Curry,1610612758,SAC,43,17,26,669.0,9,3,6,0.333,46,0.196,2,0.205,20.3,49,5,44,0.102,107,0.458,6,0.485,12.2,58,8,50,0.138,153,0.379,8,0.4,13.4
410,203498,Shabazz Muhammad,1610612750,MIN,82,29,53,1682.0,100,58,41,0.58,252,0.397,9,0.412,6.3,167,57,109,0.341,298,0.56,17,0.594,7.0,267,115,150,0.431,550,0.485,26,0.51,6.7
411,203894,Shabazz Napier,1610612753,ORL,55,23,32,600.0,9,2,7,0.222,36,0.25,0,0.25,11.9,46,9,36,0.196,72,0.639,7,0.708,8.9,55,11,43,0.2,108,0.509,7,0.545,9.4
412,203499,Shane Larkin,1610612751,BKN,78,20,58,1751.0,28,6,25,0.214,108,0.259,6,0.275,16.0,152,15,139,0.099,292,0.521,26,0.571,8.5,180,21,164,0.117,400,0.45,32,0.489,9.7
413,2733,Shaun Livingston,1610612744,GSW,78,69,9,1520.0,42,18,25,0.429,144,0.292,5,0.302,11.6,127,32,93,0.252,269,0.472,13,0.496,8.0,169,50,118,0.296,413,0.409,18,0.428,9.0
414,203963,Shayne Whittington,1610612754,IND,7,4,3,41.0,5,4,2,0.8,10,0.5,0,0.5,5.1,7,3,4,0.429,15,0.467,1,0.5,4.0,12,7,6,0.583,25,0.48,1,0.5,4.5
415,202714,Shelvin Mack,1610612762,UTA,52,27,25,1058.0,13,5,10,0.385,67,0.194,0,0.194,15.3,115,21,95,0.183,216,0.532,23,0.596,8.0,128,26,105,0.203,283,0.452,23,0.492,8.9
416,203524,Solomon Hill,1610612754,IND,59,31,28,866.0,39,23,13,0.59,108,0.361,5,0.379,7.2,127,30,96,0.236,233,0.545,20,0.596,6.0,166,53,109,0.319,341,0.487,25,0.525,6.3
417,201603,Sonny Weems,1610612756,PHX,43,6,37,498.0,7,3,5,0.429,37,0.189,3,0.206,17.1,46,7,39,0.152,77,0.597,6,0.648,5.9,53,10,44,0.189,114,0.465,9,0.505,7.5
418,203915,Spencer Dinwiddie,1610612741,CHI,12,5,7,159.0,4,2,2,0.5,11,0.364,0,0.364,8.0,13,1,12,0.077,25,0.52,1,0.542,8.5,17,3,14,0.176,36,0.472,1,0.486,8.4
419,201150,Spencer Hawes,1610612766,CHA,57,30,27,1035.0,51,34,14,0.667,135,0.378,8,0.402,6.4,193,74,119,0.383,355,0.544,35,0.603,4.6,244,108,133,0.443,490,0.498,43,0.546,5.0
420,1626169,Stanley Johnson,1610612765,DET,73,37,36,1687.0,58,33,19,0.569,210,0.276,9,0.289,6.9,248,44,203,0.177,407,0.609,23,0.646,6.4,306,77,222,0.252,617,0.496,32,0.523,6.5
421,201939,Stephen Curry,1610612744,GSW,79,71,8,2700.0,68,26,42,0.382,273,0.249,5,0.254,13.1,362,57,309,0.157,651,0.556,46,0.598,9.3,430,83,351,0.193,924,0.465,51,0.493,9.9
422,2581,Steve Blake,1610612765,DET,58,34,24,986.0,9,3,7,0.333,37,0.243,0,0.243,16.6,80,7,72,0.088,142,0.563,16,0.635,10.6,89,10,79,0.112,179,0.497,16,0.546,11.4
423,200779,Steve Novak,1610612749,MIL,10,8,2,44.0,0,0,0,0.0,1,0.0,0,0.0,0.0,5,1,4,0.2,11,0.455,1,0.5,3.8,5,1,4,0.2,12,0.417,1,0.455,3.8
424,203500,Steven Adams,1610612760,OKC,80,54,26,2014.0,219,152,53,0.694,524,0.418,20,0.435,4.9,314,109,203,0.347,720,0.436,81,0.491,4.4,533,261,256,0.49,1244,0.428,101,0.466,4.6
425,204456,T.J. McConnell,1610612755,PHI,81,10,71,1606.0,43,10,32,0.233,121,0.355,4,0.368,16.7,207,32,174,0.155,358,0.578,27,0.625,8.3,250,42,206,0.168,479,0.522,31,0.558,9.7
426,203933,T.J. Warren,1610612756,PHX,47,14,33,1070.0,57,28,28,0.491,170,0.335,5,0.345,9.9,90,23,69,0.256,157,0.573,15,0.634,9.0,147,51,97,0.347,327,0.45,20,0.479,9.4
427,201959,Taj Gibson,1610612741,CHI,73,37,36,1936.0,206,141,58,0.684,444,0.464,12,0.477,5.8,298,101,193,0.339,550,0.542,55,0.602,5.6,504,242,251,0.48,994,0.507,67,0.544,5.7
428,204028,Tarik Black,1610612747,LAL,39,6,33,496.0,44,29,14,0.659,123,0.358,5,0.373,6.1,113,36,75,0.319,181,0.624,15,0.681,4.4,157,65,89,0.414,304,0.516,20,0.553,4.9
429,2419,Tayshaun Prince,1610612750,MIN,77,27,50,1462.0,32,15,16,0.469,90,0.356,3,0.368,10.3,115,29,88,0.252,226,0.509,28,0.581,8.1,147,44,104,0.299,316,0.465,31,0.516,8.5
430,203093,Terrence Jones,1610612745,HOU,50,24,26,1044.0,62,38,21,0.613,174,0.356,6,0.369,6.8,149,64,85,0.43,274,0.544,22,0.591,5.2,211,102,106,0.483,448,0.471,28,0.502,5.7
431,203082,Terrence Ross,1610612761,TOR,72,52,20,1731.0,21,4,17,0.19,69,0.304,0,0.304,18.0,164,15,147,0.091,301,0.545,24,0.592,6.5,185,19,164,0.103,370,0.5,24,0.535,8.0
432,1626179,Terry Rozier,1610612738,BOS,38,23,15,308.0,24,12,11,0.5,54,0.444,2,0.462,11.5,39,14,25,0.359,77,0.506,6,0.549,7.5,63,26,36,0.413,131,0.481,8,0.512,9.0
433,200757,Thabo Sefolosha,1610612737,ATL,75,42,33,1758.0,52,34,17,0.654,182,0.286,7,0.297,8.3,282,55,227,0.195,461,0.612,40,0.67,7.0,334,89,244,0.266,643,0.519,47,0.56,7.2
434,201152,Thaddeus Young,1610612751,BKN,73,21,52,2407.0,176,110,66,0.625,465,0.378,20,0.396,6.9,484,137,341,0.283,729,0.664,59,0.722,5.0,660,247,407,0.374,1194,0.553,79,0.592,5.5
435,203648,Thanasis Antetokounmpo,1610612752,NYK,2,1,1,6.0,0,0,0,0.0,0,0.0,0,0.0,0.0,1,0,1,0.0,2,0.5,0,0.5,5.8,1,0,1,0.0,2,0.5,0,0.5,5.8
436,203080,Thomas Robinson,1610612751,BKN,71,16,55,916.0,136,110,22,0.809,304,0.447,8,0.459,4.7,223,75,148,0.336,342,0.652,27,0.708,4.0,359,185,170,0.515,646,0.556,35,0.588,4.2
437,201168,Tiago Splitter,1610612737,ATL,36,21,15,579.0,45,33,11,0.733,125,0.36,2,0.366,5.2,75,33,39,0.44,173,0.434,19,0.487,4.4,120,66,50,0.55,298,0.403,21,0.433,4.7
438,202353,Tibor Pleiss,1610612762,UTA,12,7,5,82.0,6,3,3,0.5,17,0.353,1,0.375,9.7,9,2,7,0.222,19,0.474,2,0.529,3.5,15,5,10,0.333,36,0.417,3,0.455,6.0
439,1495,Tim Duncan,1610612759,SAS,61,50,11,1536.0,115,70,40,0.609,269,0.428,9,0.442,6.4,332,125,204,0.377,570,0.582,44,0.631,4.7,447,195,244,0.436,839,0.533,53,0.569,5.1
440,204025,Tim Frazier,1610612740,NOP,51,25,26,741.0,26,20,6,0.769,80,0.325,2,0.333,8.1,84,13,70,0.155,166,0.506,15,0.556,8.4,110,33,76,0.3,246,0.447,17,0.48,8.3
441,203501,Tim Hardaway Jr.,1610612737,ATL,51,29,22,864.0,7,2,5,0.286,41,0.171,0,0.171,13.9,79,19,62,0.241,150,0.527,13,0.577,7.0,86,21,67,0.244,191,0.45,13,0.483,7.5
442,202389,Timofey Mozgov,1610612739,CLE,76,52,24,1326.0,110,77,32,0.7,300,0.367,5,0.373,6.0,227,94,129,0.414,451,0.503,41,0.554,5.0,337,171,161,0.507,751,0.449,46,0.478,5.3
443,202699,Tobias Harris,1610612765,DET,75,37,38,2469.0,95,53,38,0.558,305,0.311,10,0.322,6.9,404,104,296,0.257,644,0.627,52,0.682,5.8,499,157,334,0.315,949,0.526,62,0.563,6.1
444,201962,Toney Douglas,1610612740,NOP,61,22,39,1262.0,25,7,16,0.28,75,0.333,5,0.357,12.9,118,17,103,0.144,198,0.596,12,0.634,8.8,143,24,119,0.168,273,0.524,17,0.559,9.5
445,2754,Tony Allen,1610612763,MEM,64,34,30,1620.0,104,66,35,0.635,304,0.342,9,0.353,7.5,192,38,152,0.198,286,0.671,30,0.75,7.9,296,104,187,0.351,590,0.502,39,0.537,7.8
446,2225,Tony Parker,1610612759,SAS,72,59,13,1980.0,17,4,14,0.235,116,0.147,3,0.15,19.0,159,17,141,0.107,292,0.545,20,0.585,10.4,176,21,155,0.119,408,0.431,23,0.457,11.2
447,203503,Tony Snell,1610612741,CHI,64,33,31,1301.0,19,6,13,0.316,58,0.328,5,0.358,13.6,180,31,147,0.172,297,0.606,24,0.659,7.7,199,37,160,0.186,355,0.561,29,0.61,8.2
448,203100,Tony Wroten,1610612752,NYK,8,0,8,144.0,2,1,1,0.5,17,0.118,1,0.125,8.8,19,2,17,0.105,33,0.576,1,0.594,6.6,21,3,18,0.143,50,0.42,2,0.438,6.8
449,2772,Trevor Ariza,1610612745,HOU,81,40,41,2859.0,67,33,34,0.493,241,0.278,6,0.285,12.1,299,65,235,0.217,506,0.591,39,0.64,7.9,366,98,269,0.268,747,0.49,45,0.521,8.6
450,202344,Trevor Booker,1610612762,UTA,79,39,40,1632.0,166,111,52,0.669,411,0.404,9,0.413,6.1,286,97,187,0.339,477,0.6,43,0.659,4.6,452,208,239,0.46,888,0.509,52,0.541,5.2
451,203504,Trey Burke,1610612762,UTA,64,31,33,1366.0,18,6,13,0.333,78,0.231,5,0.247,18.0,94,9,86,0.096,203,0.463,9,0.485,10.8,112,15,99,0.134,281,0.399,14,0.419,12.2
452,1626168,Trey Lyles,1610612762,UTA,80,38,42,1382.0,59,38,20,0.644,182,0.324,7,0.337,8.6,240,61,178,0.254,402,0.597,40,0.663,4.8,299,99,198,0.331,584,0.512,47,0.557,5.5
453,202684,Tristan Thompson,1610612739,CLE,82,57,25,2269.0,268,191,71,0.713,677,0.396,13,0.404,5.0,470,163,303,0.347,785,0.599,80,0.667,5.0,738,354,374,0.48,1462,0.505,93,0.539,5.0
454,203584,Troy Daniels,1610612766,CHA,43,25,18,476.0,7,3,4,0.429,23,0.304,0,0.304,9.0,50,5,45,0.1,93,0.538,6,0.575,6.2,57,8,49,0.14,116,0.491,6,0.518,6.5
455,201951,Ty Lawson,1610612754,IND,66,31,35,1411.0,26,7,20,0.269,102,0.255,5,0.268,15.2,94,9,89,0.096,197,0.477,14,0.514,10.4,120,16,109,0.133,299,0.401,19,0.429,11.5
456,203898,Tyler Ennis,1610612749,MIL,46,17,29,654.0,13,7,5,0.538,47,0.277,0,0.277,8.4,62,6,57,0.097,114,0.544,5,0.569,9.8,75,13,62,0.173,161,0.466,5,0.481,9.6
457,201946,Tyler Hansbrough,1610612766,CHA,44,28,16,343.0,40,28,10,0.7,82,0.488,1,0.494,4.9,49,22,26,0.449,95,0.516,16,0.62,5.6,89,50,36,0.562,177,0.503,17,0.556,5.3
458,204020,Tyler Johnson,1610612748,MIA,36,19,17,863.0,28,13,15,0.464,83,0.337,5,0.359,9.7,81,13,68,0.16,194,0.418,19,0.463,7.9,109,26,83,0.239,277,0.394,24,0.431,8.4
459,203092,Tyler Zeller,1610612738,BOS,59,37,22,698.0,62,42,18,0.677,167,0.371,3,0.378,5.3,113,52,61,0.46,223,0.507,21,0.559,4.5,175,94,79,0.537,390,0.449,24,0.478,4.8
460,201936,Tyreke Evans,1610612740,NOP,25,11,14,765.0,20,10,10,0.5,86,0.233,4,0.244,9.5,109,15,94,0.138,172,0.634,13,0.686,8.1,129,25,104,0.194,258,0.5,17,0.535,8.3
461,2199,Tyson Chandler,1610612756,PHX,66,18,48,1618.0,175,115,55,0.657,386,0.453,10,0.465,5.4,401,115,285,0.287,629,0.638,48,0.69,4.4,576,230,340,0.399,1015,0.567,58,0.602,4.7
462,1626145,Tyus Jones,1610612750,MIN,37,13,24,573.0,7,1,6,0.143,27,0.259,3,0.292,12.8,40,5,36,0.125,80,0.5,5,0.533,8.5,47,6,42,0.128,107,0.439,8,0.475,9.1
463,2617,Udonis Haslem,1610612748,MIA,37,25,12,260.0,10,5,5,0.5,21,0.476,1,0.5,8.0,65,20,45,0.308,87,0.747,5,0.793,3.5,75,25,50,0.333,108,0.694,6,0.735,4.2
464,203506,Victor Oladipo,1610612753,ORL,71,32,39,2334.0,47,24,23,0.511,194,0.242,5,0.249,11.4,292,69,224,0.236,544,0.537,52,0.593,6.5,339,93,247,0.274,738,0.459,57,0.498,7.2
465,1713,Vince Carter,1610612763,MEM,60,33,27,1005.0,31,20,10,0.645,97,0.32,3,0.33,7.3,115,31,83,0.27,221,0.52,20,0.572,6.9,146,51,93,0.349,318,0.459,23,0.495,7.0
466,201961,Wayne Ellington,1610612751,BKN,76,18,58,1615.0,20,6,14,0.3,98,0.204,3,0.211,10.5,154,20,134,0.13,263,0.586,20,0.634,7.8,174,26,148,0.149,361,0.482,23,0.515,8.1
467,202325,Wesley Johnson,1610612746,LAC,80,51,29,1666.0,37,16,21,0.432,102,0.363,5,0.381,12.8,211,56,153,0.265,440,0.48,39,0.526,6.3,248,72,174,0.29,542,0.458,44,0.498,7.2
468,202083,Wesley Matthews,1610612742,DAL,78,40,38,2644.0,27,6,21,0.222,124,0.218,7,0.231,15.2,211,54,158,0.256,381,0.554,42,0.622,8.0,238,60,179,0.252,505,0.471,49,0.522,8.8
469,203115,Will Barton,1610612743,DEN,82,33,49,2353.0,59,31,29,0.525,261,0.226,7,0.232,11.1,417,84,332,0.201,631,0.661,44,0.71,5.2,476,115,361,0.242,892,0.534,51,0.566,5.9
470,1626161,Willie Cauley-Stein,1610612758,SAC,65,26,39,1394.0,133,86,43,0.647,264,0.504,9,0.522,5.7,214,76,141,0.355,355,0.603,41,0.682,5.8,347,162,184,0.467,619,0.561,50,0.61,5.7
471,203186,Willie Reed,1610612751,BKN,39,8,31,426.0,49,32,13,0.653,106,0.462,2,0.471,4.9,73,33,38,0.452,129,0.566,12,0.624,4.5,122,65,51,0.533,235,0.519,14,0.552,4.6
472,204098,Xavier Munford,1610612763,MEM,14,3,11,244.0,3,0,3,0.0,17,0.176,0,0.176,22.0,28,4,23,0.143,48,0.583,4,0.636,9.3,31,4,26,0.129,65,0.477,4,0.508,10.6
473,203897,Zach LaVine,1610612750,MIN,82,29,53,2293.0,27,11,15,0.407,127,0.213,6,0.223,11.3,201,30,173,0.149,357,0.563,22,0.6,8.0,228,41,188,0.18,484,0.471,28,0.5,8.4
474,2216,Zach Randolph,1610612763,MEM,68,37,31,2016.0,179,135,35,0.754,457,0.392,18,0.408,4.6,350,131,221,0.374,577,0.607,54,0.669,4.7,529,266,256,0.503,1034,0.512,72,0.55,4.7
475,2585,Zaza Pachulia,1610612742,DAL,76,40,36,2004.0,249,185,55,0.743,558,0.446,6,0.451,5.4,469,175,292,0.373,782,0.6,75,0.663,4.2,718,360,347,0.501,1340,0.536,81,0.57,4.6
